AAAP - Advanced Accelerator Applications S.A.
AAL - American Airlines Group, Inc.
AAME - Atlantic American Corporation
AAOI - Applied Optoelectronics, Inc.
AAON - AAON, Inc.
AAPC - Atlantic Alliance Partnership Corp.
AAPL - Apple Inc.
AAVL - Avalanche Biotechnologies, Inc.
AAWW - Atlas Air Worldwide Holdings
AAXJ - iShares MSCI All Country Asia ex Japan Index Fund
ABAC - Aoxin Tianli Group, Inc.
ABAX - ABAXIS, Inc.
ABCB - Ameris Bancorp
ABCD - Cambium Learning Group, Inc.
ABCO - The Advisory Board Company
ABCW - Anchor BanCorp Wisconsin Inc.
ABDC - Alcentra Capital Corp.
ABEO - Abeona Therapeutics Inc.
ABEOW - Abeona Therapeutics Inc.
ABGB - Abengoa, S.A.
ABIL - Cambridge Hold Co
ABILW - Ability Inc.
ABIO - ARCA biopharma, Inc.
ABMD - ABIOMED, Inc.
ABTL - Autobytel Inc.
ABTX - Allegiance Bancshares, Inc.
ABUS - Arbutus Biopharma Corporation
ABY - Abengoa Yield plc
ACAD - ACADIA Pharmaceuticals Inc.
ACAS - American Capital, Ltd.
ACAT - Arctic Cat Inc.
ACBI - Atlantic Capital Bancshares, Inc.
ACET - Aceto Corporation
ACFC - Atlantic Coast Financial Corporation
ACGL - Arch Capital Group Ltd.
ACHC - Acadia Healthcare Company, Inc.
ACHN - Achillion Pharmaceuticals, Inc.
ACIW - ACI Worldwide, Inc.
ACLS - Axcelis Technologies, Inc.
ACNB - ACNB Corporation
ACOR - Acorda Therapeutics, Inc.
ACPW - Active Power, Inc.
ACRS - Aclaris Therapeutics, Inc.
ACRX - AcelRx Pharmaceuticals, Inc.
ACSF - American Capital Senior Floating, Ltd.
ACST - Acasti Pharma, Inc.
ACTA - Actua Corporation
ACTG - Acacia Research Corporation
ACTS - Actions Semiconductor Co., Ltd.
ACTX - Global X Guru Activist ETF
ACUR - Acura Pharmaceuticals, Inc.
ACWI - iShares MSCI ACWI Index Fund
ACWX - iShares MSCI ACWI ex US Index Fund
ACXM - Acxiom Corporation
ADAP - Adaptimmune Therapeutics plc
ADBE - Adobe Systems Incorporated
ADHD - Alcobra Ltd.
ADI - Analog Devices, Inc.
ADMA - ADMA Biologics Inc
ADMP - Adamis Pharmaceuticals Corporation
ADMS - Adamas Pharmaceuticals, Inc.
ADP - Automatic Data Processing, Inc.
ADRA - BLDRS Asia 50 ADR Index Fund
ADRD - BLDRS Developed Markets 100 ADR Index Fund
ADRE - BLDRS Emerging Markets 50 ADR Index Fund
ADRO - Aduro Biotech, Inc.
ADRU - BLDRS Europe 100 ADR Index Fund
ADSK - Autodesk, Inc.
ADTN - ADTRAN, Inc.
ADUS - Addus HomeCare Corporation
ADXS - Advaxis, Inc.
ADXSW - Advaxis, Inc.
AEGN - Aegion Corp
AEGR - Aegerion Pharmaceuticals, Inc.
AEHR - Aehr Test Systems
AEIS - Advanced Energy Industries, Inc.
AEMD - Aethlon Medical, Inc.
AEPI - AEP Industries Inc.
AERI - Aerie Pharmaceuticals, Inc.
AETI - American Electric Technologies, Inc.
AEY - ADDvantage Technologies Group, Inc.
AEZS - AEterna Zentaris Inc.
AFAM - Almost Family Inc
AFFX - Affymetrix, Inc.
AFH - Atlas Financial Holdings, Inc.
AFMD - Affimed N.V.
AFOP - Alliance Fiber Optic Products, Inc.
AFSI - AmTrust Financial Services, Inc.
AGEN - Agenus Inc.
AGFS - AgroFresh Solutions, Inc.
AGFSW - AgroFresh Solutions, Inc.
AGII - Argo Group International Holdings, Ltd.
AGIIL - Argo Group International Holdings, Ltd.
AGIO - Agios Pharmaceuticals, Inc.
AGMX - AutoGenomics, Inc.
AGNC - American Capital Agency Corp.
AGNCB - American Capital Agency Corp.
AGNCP - American Capital Agency Corp.
AGND - WisdomTree Barclays U.S. Aggregate Bond Negative Duration Fund
AGRX - Agile Therapeutics, Inc.
AGTC - Applied Genetic Technologies Corporation
AGYS - Agilysys, Inc.
AGZD - WisdomTree Barclays U.S. Aggregate Bond Zero Duration Fund
AHGP - Alliance Holdings GP, L.P.
AHPI - Allied Healthcare Products, Inc.
AIA - iShares Asia 50 ETF
AIMC - Altra Industrial Motion Corp.
AIMT - Aimmune Therapeutics, Inc.
AINV - Apollo Investment Corporation
AIQ - Alliance HealthCare Services, Inc.
AIRM - Air Methods Corporation
AIRR - First Trust RBA American Industrial Renaissance ETF
AIRT - Air T, Inc.
AITP - Advanced Inhalation Therapies (AIT) Ltd.
AIXG - Aixtron SE
AKAM - Akamai Technologies, Inc.
AKAO - Achaogen, Inc.
AKBA - Akebia Therapeutics, Inc.
AKER - Akers Biosciences Inc
AKRX - Akorn, Inc.
AKTX - Akari Therapeutics Plc
ALCO - Alico, Inc.
ALDR - Alder BioPharmaceuticals, Inc.
ALDX - Aldeyra Therapeutics, Inc.
ALGN - Align Technology, Inc.
ALGT - Allegiant Travel Company
ALIM - Alimera Sciences, Inc.
ALKS - Alkermes plc
ALLT - Allot Communications Ltd.
ALNY - Alnylam Pharmaceuticals, Inc.
ALOG - Analogic Corporation
ALOT - Astro-Med, Inc.
ALQA - Alliqua BioMedical, Inc.
ALRM - Alarm.com Holdings, Inc.
ALSK - Alaska Communications Systems Group, Inc.
ALTY - Global X SuperDividend Alternatives ETF
ALXA - Alexza Pharmaceuticals, Inc.
ALXN - Alexion Pharmaceuticals, Inc.
AMAG - AMAG Pharmaceuticals, Inc.
AMAT - Applied Materials, Inc.
AMBA - Ambarella, Inc.
AMBC - Ambac Financial Group, Inc.
AMBCW - Ambac Financial Group, Inc.
AMCC - Applied Micro Circuits Corporation
AMCN - AirMedia Group Inc
AMCX - AMC Networks Inc.
AMD - Advanced Micro Devices, Inc.
AMDA - Amedica Corporation
AMED - Amedisys Inc
AMEH - Apollo Medical Holdings, Inc.
AMGN - Amgen Inc.
AMIC - American Independence Corp.
AMKR - Amkor Technology, Inc.
AMNB - American National Bankshares, Inc.
AMOT - Allied Motion Technologies, Inc.
AMOV - America Movil, S.A.B. de C.V.
AMPH - Amphastar Pharmaceuticals, Inc.
AMRB - American River Bankshares
AMRI - Albany Molecular Research, Inc.
AMRK - A-Mark Precious Metals, Inc.
AMRN - Amarin Corporation PLC
AMRS - Amyris, Inc.
AMSC - American Superconductor Corporation
AMSF - AMERISAFE, Inc.
AMSG - Amsurg Corp.
AMSGP - Amsurg Corp.
AMSWA - American Software, Inc.
AMTD - TD Ameritrade Holding Corporation
AMTX - Aemetis, Inc
AMWD - American Woodmark Corporation
AMZN - Amazon.com, Inc.
ANAC - Anacor Pharmaceuticals, Inc.
ANAD - ANADIGICS, Inc.
ANAT - American National Insurance Company
ANCB - Anchor Bancorp
ANCX - Access National Corporation
ANDA - Andina Acquisition Corp. II
ANDAR - Andina Acquisition Corp. II
ANDAU - Andina Acquisition Corp. II
ANDAW - Andina Acquisition Corp. II
ANDE - The Andersons, Inc.
ANGI - Angie&#39;s List, Inc.
ANGO - AngioDynamics, Inc.
ANIK - Anika Therapeutics Inc.
ANIP - ANI Pharmaceuticals, Inc.
ANSS - ANSYS, Inc.
ANTH - Anthera Pharmaceuticals, Inc.
ANY - Sphere 3D Corp.
AOSL - Alpha and Omega Semiconductor Limited
APDN - Applied DNA Sciences Inc
APDNW - Applied DNA Sciences Inc
APEI - American Public Education, Inc.
APIC - Apigee Corporation
APLP - Archrock Partners, L.P.
APOG - Apogee Enterprises, Inc.
APOL - Apollo Education Group, Inc.
APPF - AppFolio, Inc.
APPS - Digital Turbine, Inc.
APPY - Venaxis, Inc.
APRI - Apricus Biosciences, Inc
APTO - Aptose Biosciences, Inc.
APWC - Asia Pacific Wire & Cable Corporation Limited
AQMS - Aqua Metals, Inc.
AQXP - Aquinox Pharmaceuticals, Inc.
ARAY - Accuray Incorporated
ARCB - ArcBest Corporation
ARCC - Ares Capital Corporation
ARCI - Appliance Recycling Centers of America, Inc.
ARCW - ARC Group Worldwide, Inc.
ARDM - Aradigm Corporation
ARDX - Ardelyx, Inc.
AREX - Approach Resources Inc.
ARGS - Argos Therapeutics, Inc.
ARIA - ARIAD Pharmaceuticals, Inc.
ARII - American Railcar Industries, Inc.
ARIS - ARI Network Services, Inc.
ARKR - Ark Restaurants Corp.
ARLP - Alliance Resource Partners, L.P.
ARLZ - Aralez Pharmaceuticals Inc.
ARMH - ARM Holdings plc
ARNA - Arena Pharmaceuticals, Inc.
AROW - Arrow Financial Corporation
ARQL - ArQule, Inc.
ARRS - ARRIS International plc
ARRY - Array BioPharma Inc.
ARTNA - Artesian Resources Corporation
ARTW - Art&#39;s-Way Manufacturing Co., Inc.
ARTX - Arotech Corporation
ARWA - Arowana Inc.
ARWAR - Arowana Inc.
ARWAU - Arowana Inc.
ARWAW - Arowana Inc.
ARWR - Arrowhead Research Corporation
ASBB - ASB Bancorp, Inc.
ASCMA - Ascent Capital Group, Inc.
ASEI - American Science and Engineering, Inc.
ASET - FlexShares Real Assets Allocation Index Fund
ASFI - Asta Funding, Inc.
ASMB - Assembly Biosciences, Inc.
ASML - ASML Holding N.V.
ASNA - Ascena Retail Group, Inc.
ASND - Ascendis Pharma A/S
ASPS - Altisource Portfolio Solutions S.A.
ASRV - AmeriServ Financial Inc.
ASRVP - AmeriServ Financial Inc.
ASTC - Astrotech Corporation
ASTE - Astec Industries, Inc.
ASTI - Ascent Solar Technologies, Inc.
ASUR - Asure Software Inc
ASYS - Amtech Systems, Inc.
ATAI - ATA Inc.
ATAX - America First Multifamily Investors, L.P.
ATEC - Alphatec Holdings, Inc.
ATHN - athenahealth, Inc.
ATHX - Athersys, Inc.
ATLC - Atlanticus Holdings Corporation
ATLO - Ames National Corporation
ATML - Atmel Corporation
ATNI - Atlantic Tele-Network, Inc.
ATNY - API Technologies Corp.
ATOS - Atossa Genetics Inc.
ATRA - Atara Biotherapeutics, Inc.
ATRC - AtriCure, Inc.
ATRI - ATRION Corporation
ATRO - Astronics Corporation
ATRS - Antares Pharma, Inc.
ATSG - Air Transport Services Group, Inc
ATTU - Attunity Ltd.
ATVI - Activision Blizzard, Inc
AUBN - Auburn National Bancorporation, Inc.
AUDC - AudioCodes Ltd.
AUMA - AR Capital Acquisition Corp.
AUMAU - AR Capital Acquisition Corp.
AUMAW - AR Capital Acquisition Corp.
AUPH - Aurinia Pharmaceuticals Inc
AVAV - AeroVironment, Inc.
AVEO - AVEO Pharmaceuticals, Inc.
AVGO - Broadcom Limited
AVGR - Avinger, Inc.
AVHI - A V Homes, Inc.
AVID - Avid Technology, Inc.
AVNU - Avenue Financial Holdings, Inc.
AVNW - Aviat Networks, Inc.
AVXL - Anavex Life Sciences Corp.
AVXS - AveXis, Inc.
AWRE - Aware, Inc.
AXAS - Abraxas Petroleum Corporation
AXDX - Accelerate Diagnostics, Inc.
AXGN - AxoGen, Inc.
AXSM - Axsome Therapeutics, Inc.
AXTI - AXT Inc
AYA - Amaya Inc.
AZPN - Aspen Technology, Inc.
BABY - Natus Medical Incorporated
BANF - BancFirst Corporation
BANFP - BancFirst Corporation
BANR - Banner Corporation
BANX - StoneCastle Financial Corp
BASI - Bioanalytical Systems, Inc.
BBBY - Bed Bath & Beyond Inc.
BBC - BioShares Biotechnology Clinical Trials Fund
BBCN - BBCN Bancorp, Inc.
BBEP - Breitburn Energy Partners LP
BBEPP - Breitburn Energy Partners LP
BBGI - Beasley Broadcast Group, Inc.
BBH - Market Vectors Biotech ETF
BBLU - Blue Earth, Inc.
BBOX - Black Box Corporation
BBP - BioShares Biotechnology Products Fund
BBRG - Bravo Brio Restaurant Group, Inc.
BBRY - BlackBerry Limited
BBSI - Barrett Business Services, Inc.
BCBP - BCB Bancorp, Inc. (NJ)
BCDA - BioCardia, Inc.
BCLI - Brainstorm Cell Therapeutics Inc.
BCOM - B Communications Ltd.
BCOR - Blucora, Inc.
BCOV - Brightcove Inc.
BCPC - Balchem Corporation
BCRX - BioCryst Pharmaceuticals, Inc.
BDE - Black Diamond, Inc.
BDGE - Bridge Bancorp, Inc.
BDMS - Birner Dental Management Services, Inc.
BDSI - BioDelivery Sciences International, Inc.
BEAT - BioTelemetry, Inc.
BEAV - B/E Aerospace, Inc.
BEBE - bebe stores, inc.
BECN - Beacon Roofing Supply, Inc.
BELFA - Bel Fuse Inc.
BELFB - Bel Fuse Inc.
BFIN - BankFinancial Corporation
BGCP - BGC Partners, Inc.
BGFV - Big 5 Sporting Goods Corporation
BGNE - BeiGene, Ltd.
BHAC - Barington/Hilco Acquisition Corp.
BHACR - Barington/Hilco Acquisition Corp.
BHACU - Barington/Hilco Acquisition Corp.
BHACW - Barington/Hilco Acquisition Corp.
BHBK - Blue Hills Bancorp, Inc.
BIB - ProShares Ultra Nasdaq Biotechnology
BICK - First Trust BICK Index Fund
BIDU - Baidu, Inc.
BIIB - Biogen Inc.
BIND - BIND Therapeutics, Inc.
BIOC - Biocept, Inc.
BIOD - Biodel Inc.
BIOL - Biolase, Inc.
BIOS - BioScrip, Inc.
BIS - ProShares UltraShort Nasdaq Biotechnology
BITE - The Restaurant ETF
BITI - Biotie Therapies Corp.
BJRI - BJ&#39;s Restaurants, Inc.
BKCC - BlackRock Capital Investment Corporation
BKEP - Blueknight Energy Partners L.P., L.L.C.
BKEPP - Blueknight Energy Partners L.P., L.L.C.
BKMU - Bank Mutual Corporation
BKSC - Bank of South Carolina Corp.
BLBD - Blue Bird Corporation
BLCM - Bellicum Pharmaceuticals, Inc.
BLDP - Ballard Power Systems, Inc.
BLDR - Builders FirstSource, Inc.
BLFS - BioLife Solutions, Inc.
BLIN - Bridgeline Digital, Inc.
BLKB - Blackbaud, Inc.
BLMN - Bloomin&#39; Brands, Inc.
BLMT - BSB Bancorp, Inc.
BLPH - Bellerophon Therapeutics, Inc.
BLRX - BioLineRx Ltd.
BLUE - bluebird bio, Inc.
BLVD - Boulevard Acquisition Corp. II
BLVDU - Boulevard Acquisition Corp. II
BLVDW - Boulevard Acquisition Corp. II
BMRC - Bank of Marin Bancorp
BMRN - BioMarin Pharmaceutical Inc.
BMTC - Bryn Mawr Bank Corporation
BNCL - Beneficial Bancorp, Inc.
BNCN - BNC Bancorp
BNDX - Vanguard Total International Bond ETF
BNFT - Benefitfocus, Inc.
BNSO - Bonso Electronics International, Inc.
BNTC - Benitec Biopharma Limited
BNTCW - Benitec Biopharma Limited
BOBE - Bob Evans Farms, Inc.
BOCH - Bank of Commerce Holdings (CA)
BOFI - BofI Holding, Inc.
BOJA - Bojangles&#39;, Inc.
BOKF - BOK Financial Corporation
BONA - Bona Film Group Limited
BONT - The Bon-Ton Stores, Inc.
BOOM - Dynamic Materials Corporation
BOSC - B.O.S. Better Online Solutions
BOTA - Biota Pharmaceuticals, Inc.
BOTJ - Bank of the James Financial Group, Inc.
BOXL - Boxlight Corporation
BPFH - Boston Private Financial Holdings, Inc.
BPFHP - Boston Private Financial Holdings, Inc.
BPFHW - Boston Private Financial Holdings, Inc.
BPMC - Blueprint Medicines Corporation
BPOP - Popular, Inc.
BPOPM - Popular, Inc.
BPOPN - Popular, Inc.
BPTH - Bio-Path Holdings, Inc.
BRCD - Brocade Communications Systems, Inc.
BREW - Craft Brew Alliance, Inc.
BRID - Bridgford Foods Corporation
BRKL - Brookline Bancorp, Inc.
BRKR - Bruker Corporation
BRKS - Brooks Automation, Inc.
BSET - Bassett Furniture Industries, Incorporated
BSF - Bear State Financial, Inc.
BSFT - BroadSoft, Inc.
BSPM - Biostar Pharmaceuticals, Inc.
BSQR - BSQUARE Corporation
BSRR - Sierra Bancorp
BSTC - BioSpecifics Technologies Corp
BUFF - Blue Buffalo Pet Products, Inc.
BUR - Burcon Nutrascience Corp
BUSE - First Busey Corporation
BV - Bazaarvoice, Inc.
BVA - Cordia Bancorp Inc.
BVSN - BroadVision, Inc.
BVXV - BiondVax Pharmaceuticals Ltd.
BVXVW - BiondVax Pharmaceuticals Ltd.
BWEN - Broadwind Energy, Inc.
BWFG - Bankwell Financial Group, Inc.
BWINA - Baldwin & Lyons, Inc.
BWINB - Baldwin & Lyons, Inc.
BWLD - Buffalo Wild Wings, Inc.
BYBK - Bay Bancorp, Inc.
BYFC - Broadway Financial Corporation
BYLK - Baylake Corp
BZUN - Baozun Inc.
CA - CA Inc.
CAAS - China Automotive Systems, Inc.
CAC - Camden National Corporation
CACB - Cascade Bancorp
CACC - Credit Acceptance Corporation
CACQ - Caesars Acquisition Company
CADC - China Advanced Construction Materials Group, Inc.
CADT - DT Asia Investments Limited
CADTR - DT Asia Investments Limited
CADTU - DT Asia Investments Limited
CADTW - DT Asia Investments Limited
CAFD - 8point3 Energy Partners LP
CAKE - The Cheesecake Factory Incorporated
CALA - Calithera Biosciences, Inc.
CALD - Callidus Software, Inc.
CALI - China Auto Logistics Inc.
CALL - magicJack VocalTec Ltd
CALM - Cal-Maine Foods, Inc.
CAMP - CalAmp Corp.
CAMT - Camtek Ltd.
CAPN - Capnia, Inc.
CAPNW - Capnia, Inc.
CAPR - Capricor Therapeutics, Inc.
CAPX - Elkhorn S&P 500 Capital Expenditures Portfolio
CAR - Avis Budget Group, Inc.
CARA - Cara Therapeutics, Inc.
CARB - Carbonite, Inc.
CARO - Carolina Financial Corporation
CART - Carolina Trust Bank
CARV - Carver Bancorp, Inc.
CARZ - First Trust NASDAQ Global Auto Index Fund
CASH - Meta Financial Group, Inc.
CASI - CASI Pharmaceuticals, Inc.
CASM - CAS Medical Systems, Inc.
CASS - Cass Information Systems, Inc
CASY - Caseys General Stores, Inc.
CATB - Catabasis Pharmaceuticals, Inc.
CATM - Cardtronics, Inc.
CATY - Cathay General Bancorp
CATYW - Cathay General Bancorp
CAVM - Cavium, Inc.
CBAK - China BAK Battery, Inc.
CBAN - Colony Bankcorp, Inc.
CBAY - Cymabay Therapeutics Inc.
CBF - Capital Bank Financial Corp.
CBFV - CB Financial Services, Inc.
CBIO - Catalyst Biosciences, Inc.
CBLI - Cleveland BioLabs, Inc.
CBMG - Cellular Biomedicine Group, Inc.
CBMX - CombiMatrix Corporation
CBNJ - Cape Bancorp, Inc.
CBNK - Chicopee Bancorp, Inc.
CBOE - CBOE Holdings, Inc.
CBPO - China Biologic Products, Inc.
CBRL - Cracker Barrel Old Country Store, Inc.
CBSH - Commerce Bancshares, Inc.
CBSHP - Commerce Bancshares, Inc.
CBYL - Carbylan Therapeutics, Inc.
CCBG - Capital City Bank Group
CCCL - China Ceramics Co., Ltd.
CCCR - China Commercial Credit, Inc.
CCD - Calamos Dynamic Convertible & Income Fund
CCFI - Community Choice Financial Inc.
CCIH - ChinaCache International Holdings Ltd.
CCLP - CSI Compressco LP
CCMP - Cabot Microelectronics Corporation
CCNE - CNB Financial Corporation
CCOI - Cogent Communications Holdings, Inc.
CCRC - China Customer Relations Centers, Inc.
CCRN - Cross Country Healthcare, Inc.
CCUR - Concurrent Computer Corporation
CCXI - ChemoCentryx, Inc.
CDC - Victory CEMP US EQ Income Enhanced Volatility Wtd Index ETF
CDK - CDK Global, Inc.
CDL - Victory CEMP US Large Cap High Div Volatility Wtd Index ETF
CDNA - CareDx, Inc.
CDNS - Cadence Design Systems, Inc.
CDOR - Condor Hospitality Trust, Inc.
CDORO - Condor Hospitality Trust, Inc.
CDORP - Condor Hospitality Trust, Inc.
CDRB - Code Rebel Corporation
CDTI - Clean Diesel Technologies, Inc.
CDTX - Cidara Therapeutics, Inc.
CDW - CDW Corporation
CDXS - Codexis, Inc.
CDZI - Cadiz, Inc.
CECE - CECO Environmental Corp.
CECO - Career Education Corporation
CELG - Celgene Corporation
CELGZ - Celgene Corporation
CEMI - Chembio Diagnostics, Inc.
CEMP - Cempra, Inc.
CENT - Central Garden & Pet Company
CENTA - Central Garden & Pet Company
CENX - Century Aluminum Company
CERC - Cerecor Inc.
CERCW - Cerecor Inc.
CERCZ - Cerecor Inc.
CERE - Ceres, Inc.
CERN - Cerner Corporation
CERS - Cerus Corporation
CERU - Cerulean Pharma Inc.
CETC - Hongli Clean Energy Technologies Corp.
CETV - Central European Media Enterprises Ltd.
CETX - Cemtrex Inc.
CEVA - CEVA, Inc.
CFA - Victory CEMP US 500 Volatility Wtd Index ETF
CFBK - Central Federal Corporation
CFCB - Centrue Financial Corporation
CFFI - C&F Financial Corporation
CFFN - Capitol Federal Financial, Inc.
CFGE - Calamos Focus Growth ETF
CFMS - ConforMIS, Inc.
CFNB - California First National Bancorp
CFNL - Cardinal Financial Corporation
CFO - Victory CEMP US 500 Enhanced Volatility Wtd Index ETF
CFRX - ContraFect Corporation
CFRXW - ContraFect Corporation
CG - The Carlyle Group L.P.
CGEN - Compugen Ltd.
CGIX - Cancer Genetics, Inc.
CGNT - Cogentix Medical, Inc.
CGNX - Cognex Corporation
CGO - Calamos Global Total Return Fund
CHCI - Comstock Holding Companies, Inc.
CHCO - City Holding Company
CHDN - Churchill Downs, Incorporated
CHEF - The Chefs&#39; Warehouse, Inc.
CHEK - Check-Cap Ltd.
CHEKW - Check-Cap Ltd.
CHEV - Cheviot Financial Corp
CHFC - Chemical Financial Corporation
CHFN - Charter Financial Corp.
CHI - Calamos Convertible Opportunities and Income Fund
CHKE - Cherokee Inc.
CHKP - Check Point Software Technologies Ltd.
CHMA - Chiasma, Inc.
CHMG - Chemung Financial Corp
CHNR - China Natural Resources, Inc.
CHRS - Coherus BioSciences, Inc.
CHRW - C.H. Robinson Worldwide, Inc.
CHSCL - CHS Inc
CHSCM - CHS Inc
CHSCN - CHS Inc
CHSCO - CHS Inc
CHSCP - CHS Inc
CHTR - Charter Communications, Inc.
CHUY - Chuy&#39;s Holdings, Inc.
CHW - Calamos Global Dynamic Income Fund
CHY - Calamos Convertible and High Income Fund
CIBR - First Trust NASDAQ Cybersecurity ETF
CID - Victory CEMP International High Div Volatility Wtd Index ETF
CIDM - Cinedigm Corp
CIFC - CIFC LLC
CIGI - Colliers International Group Inc.
CIL - Victory CEMP International Volatility Wtd Index ETF
CINF - Cincinnati Financial Corporation
CISG - CNinsure Inc.
CIVB - Civista Bancshares, Inc.
CIVBP - Civista Bancshares, Inc.
CIZ - Victory CEMP Developed Enhanced Volatility Wtd Index ETF
CIZN - Citizens Holding Company
CJJD - China Jo-Jo Drugstores, Inc.
CKEC - Carmike Cinemas, Inc.
CLAC - Capitol Acquisition Corp. III
CLACU - Capitol Acquisition Corp. III
CLACW - Capitol Acquisition Corp. III
CLBH - Carolina Bank Holdings Inc.
CLBS - Caladrius Biosciences, Inc.
CLCD - CoLucid Pharmaceuticals, Inc.
CLCT - Collectors Universe, Inc.
CLDN - Celladon Corporation
CLDX - Celldex Therapeutics, Inc.
CLFD - Clearfield, Inc.
CLIR - ClearSign Combustion Corporation
CLLS - Cellectis S.A.
CLMS - Calamos Asset Management, Inc.
CLMT - Calumet Specialty Products Partners, L.P.
CLNE - Clean Energy Fuels Corp.
CLNT - Cleantech Solutions International, Inc.
CLRB - Cellectar Biosciences, Inc.
CLRBW - Cellectar Biosciences, Inc.
CLRO - ClearOne, Inc.
CLSN - Celsion Corporation
CLUB - Town Sports International Holdings, Inc.
CLVS - Clovis Oncology, Inc.
CLWT - Euro Tech Holdings Company Limited
CMCO - Columbus McKinnon Corporation
CMCSA - Comcast Corporation
CMCT - CIM Commercial Trust Corporation
CME - CME Group Inc.
CMFN - CM Finance Inc
CMLS - Cumulus Media Inc.
CMPR - Cimpress N.V
CMRX - Chimerix, Inc.
CMTL - Comtech Telecommunications Corp.
CNAT - Conatus Pharmaceuticals Inc.
CNBKA - Century Bancorp, Inc.
CNCE - Concert Pharmaceuticals, Inc.
CNCR - Loncar Cancer Immunotherapy ETF
CNET - ChinaNet Online Holdings, Inc.
CNFR - Conifer Holdings, Inc.
CNIT - China Information Technology, Inc.
CNLM - CB Pharma Acquisition Corp.
CNLMR - CB Pharma Acquisition Corp.
CNLMU - CB Pharma Acquisition Corp.
CNLMW - CB Pharma Acquisition Corp.
CNMD - CONMED Corporation
CNOB - ConnectOne Bancorp, Inc.
CNSL - Consolidated Communications Holdings, Inc.
CNTF - China TechFaith Wireless Communication Technology Limited
CNTY - Century Casinos, Inc.
CNV - Cnova N.V.
CNXR - Connecture, Inc.
CNYD - China Yida Holding, Co.
COB - CommunityOne Bancorp
COBZ - CoBiz Financial Inc.
COHR - Coherent, Inc.
COHU - Cohu, Inc.
COKE - Coca-Cola Bottling Co. Consolidated
COLB - Columbia Banking System, Inc.
COLL - Collegium Pharmaceutical, Inc.
COLM - Columbia Sportswear Company
COMM - CommScope Holding Company, Inc.
COMT - iShares Commodities Select Strategy ETF
CONE - CyrusOne Inc
CONG - congatec Holding AG
CONN - Conn&#39;s, Inc.
COOL - Majesco Entertainment Company
CORE - Core-Mark Holding Company, Inc.
CORI - Corium International, Inc.
CORT - Corcept Therapeutics Incorporated
COSI - Cosi, Inc.
COST - Costco Wholesale Corporation
COVS - Covisint Corporation
COWN - Cowen Group, Inc.
COWNL - Cowen Group, Inc.
COYN - COPsync, Inc.
COYNW - COPsync, Inc.
CPAH - CounterPath Corporation
CPHC - Canterbury Park Holding Corporation
CPHD - CEPHEID
CPHR - Cipher Pharmaceuticals Inc.
CPIX - Cumberland Pharmaceuticals Inc.
CPLA - Capella Education Company
CPLP - Capital Product Partners L.P.
CPRT - Copart, Inc.
CPRX - Catalyst Pharmaceuticals, Inc.
CPSH - CPS Technologies Corp.
CPSI - Computer Programs and Systems, Inc.
CPSS - Consumer Portfolio Services, Inc.
CPST - Capstone Turbine Corporation
CPTA - Capitala Finance Corp.
CPXX - Celator Pharmaceuticals Inc.
CRAI - CRA International,Inc.
CRAY - Cray Inc
CRBP - Corbus Pharmaceuticals Holdings, Inc.
CRDC - Cardica, Inc.
CRDS - Crossroads Systems, Inc.
CRDT - WisdomTree Strategic Corporate Bond Fund
CREE - Cree, Inc.
CREG - China Recycling Energy Corporation
CRESY - Cresud S.A.C.I.F. y A.
CRIS - Curis, Inc.
CRME - Cardiome Pharma Corporation
CRMT - America&#39;s Car-Mart, Inc.
CRNT - Ceragon Networks Ltd.
CROX - Crocs, Inc.
CRTN - Cartesian, Inc.
CRTO - Criteo S.A.
CRUS - Cirrus Logic, Inc.
CRVL - CorVel Corp.
CRWN - Crown Media Holdings, Inc.
CRWS - Crown Crafts, Inc.
CRZO - Carrizo Oil & Gas, Inc.
CSA - Victory CEMP US Small Cap Volatility Wtd Index ETF
CSAL - Communications Sales & Leasing,Inc.
CSB - Victory CEMP US Small Cap High Div Volatility Wtd Index ETF
CSBK - Clifton Bancorp Inc.
CSBR - Champions Oncology, Inc.
CSCD - Cascade Microtech, Inc.
CSCO - Cisco Systems, Inc.
CSF - Victory CEMP US Discovery Enhanced Volatility Wtd Index ETF
CSFL - CenterState Banks, Inc.
CSGP - CoStar Group, Inc.
CSGS - CSG Systems International, Inc.
CSII - Cardiovascular Systems, Inc.
CSIQ - Canadian Solar Inc.
CSOD - Cornerstone OnDemand, Inc.
CSPI - CSP Inc.
CSQ - Calamos Strategic Total Return Fund
CSTE - CaesarStone Sdot-Yam Ltd.
CSUN - China Sunergy Co., Ltd.
CSWC - Capital Southwest Corporation
CSWI - CSW Industrials, Inc.
CSX - CSX Corporation
CTAS - Cintas Corporation
CTBI - Community Trust Bancorp, Inc.
CTCM - CTC Media, Inc.
CTG - Computer Task Group, Incorporated
CTHR - Charles & Colvard Ltd
CTIB - CTI Industries Corporation
CTIC - CTI BioPharma Corp.
CTMX - CytomX Therapeutics, Inc.
CTRE - CareTrust REIT, Inc.
CTRL - Control4 Corporation
CTRN - Citi Trends, Inc.
CTRP - Ctrip.com International, Ltd.
CTRV - ContraVir Pharmaceuticals Inc
CTSH - Cognizant Technology Solutions Corporation
CTSO - Cytosorbents Corporation
CTWS - Connecticut Water Service, Inc.
CTXS - Citrix Systems, Inc.
CUBA - The Herzfeld Caribbean Basin Fund, Inc.
CUBN - Commerce Union Bancshares, Inc.
CUI - CUI Global, Inc.
CUNB - CU Bancorp (CA)
CUR - Neuralstem, Inc.
CURM - Cur Media, Inc.
CUTR - Cutera, Inc.
CVBF - CVB Financial Corporation
CVCO - Cavco Industries, Inc.
CVCY - Central Valley Community Bancorp
CVGI - Commercial Vehicle Group, Inc.
CVGW - Calavo Growers, Inc.
CVLT - CommVault Systems, Inc.
CVLY - Codorus Valley Bancorp, Inc
CVTI - Covenant Transportation Group, Inc.
CVV - CVD Equipment Corporation
CWAY - Coastway Bancorp, Inc.
CWBC - Community West Bancshares
CWCO - Consolidated Water Co. Ltd.
CWST - Casella Waste Systems, Inc.
CXDC - China XD Plastics Company Limited
CXRX - Concordia Healthcare Corp.
CXSE - WisdomTree China ex-State-Owned Enterprises Fund
CY - Cypress Semiconductor Corporation
CYAD - Celyad SA
CYAN - Cyanotech Corporation
CYBE - CyberOptics Corporation
CYBR - CyberArk Software Ltd.
CYCC - Cyclacel Pharmaceuticals, Inc.
CYCCP - Cyclacel Pharmaceuticals, Inc.
CYHHZ - Community Health Systems, Inc.
CYNA - Cynapsus Therapeutics Inc.
CYNO - Cynosure, Inc.
CYOU - Changyou.com Limited
CYRN - CYREN Ltd.
CYRX - CryoPort, Inc.
CYRXW - CryoPort, Inc.
CYTK - Cytokinetics, Incorporated
CYTR - CytRx Corporation
CYTX - Cytori Therapeutics Inc
CZFC - Citizens First Corporation
CZNC - Citizens & Northern Corp
CZR - Caesars Entertainment Corporation
CZWI - Citizens Community Bancorp, Inc.
DAIO - Data I/O Corporation
DAKT - Daktronics, Inc.
DATE - Jiayuan.com International Ltd.
DAVE - Famous Dave&#39;s of America, Inc.
DAX - Recon Capital DAX Germany ETF
DBVT - DBV Technologies S.A.
DCIX - Diana Containerships Inc.
DCOM - Dime Community Bancshares, Inc.
DCTH - Delcath Systems, Inc.
DDAY - DraftDay Fantasy Sports, Inc.
DDBI - Legg Mason Developed EX-US Diversified Core ETF
DELT - Delta Technology Holdings Limited
DELTW - Delta Technology Holdings Limited
DENN - Denny&#39;s Corporation
DEPO - Depomed, Inc.
DERM - Dermira, Inc.
DEST - Destination Maternity Corporation
DFBG - Differential Brands Group Inc.
DFRG - Del Frisco&#39;s Restaurant Group, Inc.
DFVL - region
DFVS - region
DGAS - Delta Natural Gas Company, Inc.
DGICA - Donegal Group, Inc.
DGICB - Donegal Group, Inc.
DGII - Digi International Inc.
DGLD - region
DGLY - Digital Ally, Inc.
DGRE - WisdomTree Emerging Markets Quality Dividend Growth Fund
DGRS - WisdomTree U.S. SmallCap Quality Dividend Growth Fund
DGRW - WisdomTree U.S. Quality Dividend Growth Fund
DHIL - Diamond Hill Investment Group, Inc.
DHRM - Dehaier Medical Systems Limited
DHXM - DHX Media Ltd.
DIOD - Diodes Incorporated
DISCA - Discovery Communications, Inc.
DISCB - Discovery Communications, Inc.
DISCK - Discovery Communications, Inc.
DISH - DISH Network Corporation
DJCO - Daily Journal Corp. (S.C.)
DLBL - region
DLBS - region
DLHC - DLH Holdings Corp.
DLTH - Duluth Holdings Inc.
DLTR - Dollar Tree, Inc.
DMLP - Dorchester Minerals, L.P.
DMND - Diamond Foods, Inc.
DMRC - Digimarc Corporation
DMTX - Dimension Therapeutics, Inc.
DNAI - ProNAi Therapeutics, Inc.
DNBF - DNB Financial Corp
DNKN - Dunkin&#39; Brands Group, Inc.
DORM - Dorman Products, Inc.
DOX - Amdocs Limited
DPRX - Dipexium Pharmaceuticals, Inc.
DRAD - Digirad Corporation
DRAM - Dataram Corporation
DRNA - Dicerna Pharmaceuticals, Inc.
DRRX - Durect Corporation
DRWI - DragonWave Inc
DRWIW - DragonWave Inc
DRYS - DryShips Inc.
DSCI - Derma Sciences, Inc.
DSCO - Discovery Laboratories, Inc.
DSGX - The Descartes Systems Group Inc.
DSKX - DS Healthcare Group, Inc.
DSKY - iDreamSky Technology Limited
DSLV - region
DSPG - DSP Group, Inc.
DSWL - Deswell Industries, Inc.
DTEA - DAVIDsTEA Inc.
DTLK - Datalink Corporation
DTRM - Determine, Inc.
DTSI - DTS, Inc.
DTUL - region
DTUS - region
DTYL - region
DTYS - region
DVAX - Dynavax Technologies Corporation
DVCR - Diversicare Healthcare Services Inc.
DWA - Dreamworks Animation SKG, Inc.
DWAT - Arrow DWA Tactical ETF
DWCH - Datawatch Corporation
DWSN - Dawson Geophysical Company
DWTR - PowerShares DWA Tactical Sector Rotation Portfolio
DXCM - DexCom, Inc.
DXGE - WisdomTree Germany Hedged Equity Fund
DXJS - WisdomTree Japan Hedged SmallCap Equity Fund
DXKW - WisdomTree Korea Hedged Equity Fund
DXLG - Destination XL Group, Inc.
DXPE - DXP Enterprises, Inc.
DXPS - WisdomTree United Kingdom Hedged Equity Fund
DXYN - The Dixie Group, Inc.
DYNT - Dynatronics Corporation
DYSL - Dynasil Corporation of America
EA - Electronic Arts Inc.
EAC - Erickson Incorporated
EACQ - Easterly Acquisition Corp.
EACQU - Easterly Acquisition Corp.
EACQW - Easterly Acquisition Corp.
EAGL - Double Eagle Acquisition Corp.
EAGLU - Double Eagle Acquisition Corp.
EAGLW - Double Eagle Acquisition Corp.
EARS - Auris Medical Holding AG
EBAY - eBay Inc.
EBIO - Eleven Biotherapeutics, Inc.
EBIX - Ebix, Inc.
EBMT - Eagle Bancorp Montana, Inc.
EBSB - Meridian Bancorp, Inc.
EBTC - Enterprise Bancorp Inc
ECAC - E-compass Acquisition Corp.
ECACR - E-compass Acquisition Corp.
ECACU - E-compass Acquisition Corp.
ECHO - Echo Global Logistics, Inc.
ECOL - US Ecology, Inc.
ECPG - Encore Capital Group Inc
ECTE - Echo Therapeutics, Inc.
ECYT - Endocyte, Inc.
EDAP - EDAP TMS S.A.
EDBI - Legg Mason Emerging Markets Diversified Core ETF
EDGE - Edge Therapeutics, Inc.
EDGW - Edgewater Technology, Inc.
EDIT - Editas Medicine, Inc.
EDUC - Educational Development Corporation
EEFT - Euronet Worldwide, Inc.
EEI - Ecology and Environment, Inc.
EEMA - iShares MSCI Emerging Markets Asia Index Fund
EEML - iShares MSCI Emerging Markets Latin America Index Fund
EFII - Electronics for Imaging, Inc.
EFOI - Energy Focus, Inc.
EFSC - Enterprise Financial Services Corporation
EFUT - eFuture Holding Inc.
EGAN - eGain Corporation
EGBN - Eagle Bancorp, Inc.
EGHT - 8x8 Inc
EGLE - Eagle Bulk Shipping Inc.
EGLT - Egalet Corporation
EGOV - NIC Inc.
EGRX - Eagle Pharmaceuticals, Inc.
EGT - Entertainment Gaming Asia Incorporated
EHTH - eHealth, Inc.
EIGI - Endurance International Group Holdings, Inc.
ELEC - Electrum Special Acquisition Corporation
ELECU - Electrum Special Acquisition Corporation
ELECW - Electrum Special Acquisition Corporation
ELGX - Endologix, Inc.
ELNK - EarthLink Holdings Corp.
ELON - Echelon Corporation
ELOS - Syneron Medical Ltd.
ELRC - Electro Rent Corporation
ELSE - Electro-Sensors, Inc.
ELTK - Eltek Ltd.
EMCB - WisdomTree Emerging Markets Corporate Bond Fund
EMCF - Emclaire Financial Corp
EMCG - WisdomTree Emerging Markets Consumer Growth Fund
EMCI - EMC Insurance Group Inc.
EMIF - iShares S&P Emerging Markets Infrastructure Index Fund
EMITF - Elbit Imaging Ltd.
EMKR - EMCORE Corporation
EML - Eastern Company (The)
EMMS - Emmis Communications Corporation
EMMSP - Emmis Communications Corporation
ENDP - Endo International plc
ENFC - Entegra Financial Corp.
ENG - ENGlobal Corporation
ENOC - EnerNOC, Inc.
ENPH - Enphase Energy, Inc.
ENSG - The Ensign Group, Inc.
ENT - Global Eagle Entertainment Inc.
ENTA - Enanta Pharmaceuticals, Inc.
ENTG - Entegris, Inc.
ENTL - Entellus Medical, Inc.
ENZL - iShares MSCI New Zealand Capped ETF
ENZN - Enzon Pharmaceuticals, Inc.
ENZY - Enzymotec Ltd.
EPAY - Bottomline Technologies, Inc.
EPIQ - EPIQ Systems, Inc.
EPIX - ESSA Pharma Inc.
EPRS - EPIRUS Biopharmaceuticals, Inc.
EPZM - Epizyme, Inc.
EQBK - Equity Bancshares, Inc.
EQFN - Equitable Financial Corp.
EQIX - Equinix, Inc.
ERI - Eldorado Resorts, Inc.
ERIC - Ericsson
ERIE - Erie Indemnity Company
ERII - Energy Recovery, Inc.
ERS - Empire Resources, Inc.
ERW - Janus Equal Risk Weighted Large Cap ETF
ESBK - Elmira Savings Bank NY (The)
ESCA - Escalade, Incorporated
ESEA - Euroseas Ltd.
ESES - Eco-Stim Energy Solutions, Inc.
ESGR - Enstar Group Limited
ESIO - Electro Scientific Industries, Inc.
ESLT - Elbit Systems Ltd.
ESMC - Escalon Medical Corp.
ESND - Essendant Inc.
ESPR - Esperion Therapeutics, Inc.
ESRX - Express Scripts Holding Company
ESSA - ESSA Bancorp, Inc.
ESSF - ETRE REIT, LLC
ESXB - Community Bankers Trust Corporation.
ETFC - E*TRADE Financial Corporation
ETRM - EnteroMedics Inc.
ETSY - Etsy, Inc.
EUFN - iShares MSCI Europe Financials Sector Index Fund
EVAR - Lombard Medical, Inc.
EVBS - Eastern Virginia Bankshares, Inc.
EVEP - EV Energy Partners, L.P.
EVK - Ever-Glory International Group, Inc.
EVLV - EVINE Live Inc.
EVOK - Evoke Pharma, Inc.
EVOL - Evolving Systems, Inc.
EWBC - East West Bancorp, Inc.
EWZS - iShares MSCI Brazil Small-Cap ETF
EXA - Exa Corporation
EXAC - Exactech, Inc.
EXAS - EXACT Sciences Corporation
EXEL - Exelixis, Inc.
EXFO - EXFO Inc
EXLS - ExlService Holdings, Inc.
EXPD - Expeditors International of Washington, Inc.
EXPE - Expedia, Inc.
EXPO - Exponent, Inc.
EXTR - Extreme Networks, Inc.
EXXI - Energy XXI Ltd.
EYEG - Eyegate Pharmaceuticals, Inc.
EYEGW - Eyegate Pharmaceuticals, Inc.
EYES - Second Sight Medical Products, Inc.
EZPW - EZCORP, Inc.
FALC - FalconStor Software, Inc.
FANG - Diamondback Energy, Inc.
FARM - Farmer Brothers Company
FARO - FARO Technologies, Inc.
FAST - Fastenal Company
FATE - Fate Therapeutics, Inc.
FB - Facebook, Inc.
FBIO - Fortress Biotech, Inc.
FBIZ - First Business Financial Services, Inc.
FBMS - The First Bancshares, Inc.
FBNC - First Bancorp
FBNK - First Connecticut Bancorp, Inc.
FBRC - FBR & Co
FBSS - Fauquier Bankshares, Inc.
FBZ - First Trust Brazil AlphaDEX Fund
FCA - First Trust China AlphaDEX Fund
FCAN - First Trust Canada AlphaDEX Fund
FCAP - First Capital, Inc.
FCBC - First Community Bancshares, Inc.
FCCO - First Community Corporation
FCCY - 1st Constitution Bancorp (NJ)
FCEL - FuelCell Energy, Inc.
FCFP - First Community Financial Partners, Inc.
FCFS - First Cash Financial Services, Inc.
FCLF - First Clover Leaf Financial Corp.
FCNCA - First Citizens BancShares, Inc.
FCS - Fairchild Semiconductor International, Inc.
FCSC - Fibrocell Science Inc
FCTY - 1st Century Bancshares, Inc
FCVT - First Trust SSI Strategic Convertible Securities ETF
FDEF - First Defiance Financial Corp.
FDIV - First Trust Strategic Income ETF
FDML - Federal-Mogul Holdings Corporation
FDT - First Trust Developed Markets Ex-US AlphaDEX Fund
FDTS - First Trust Developed Markets ex-US Small Cap AlphaDEX Fund
FDUS - Fidus Investment Corporation
FEIC - FEI Company
FEIM - Frequency Electronics, Inc.
FELE - Franklin Electric Co., Inc.
FEM - First Trust Emerging Markets AlphaDEX Fund
FEMB - First Trust Emerging Markets Local Currency Bond ETF
FEMS - First Trust Emerging Markets Small Cap AlphaDEX Fund
FENX - Fenix Parts, Inc.
FEP - First Trust Europe AlphaDEX Fund
FES - Forbes Energy Services Ltd
FEUZ - First Trust Eurozone AlphaDEX ETF
FEYE - FireEye, Inc.
FFBC - First Financial Bancorp.
FFBCW - First Financial Bancorp.
FFHL - Fuwei Films (Holdings) Co., Ltd.
FFIC - Flushing Financial Corporation
FFIN - First Financial Bankshares, Inc.
FFIV - F5 Networks, Inc.
FFKT - Farmers Capital Bank Corporation
FFNW - First Financial Northwest, Inc.
FFWM - First Foundation Inc.
FGBI - First Guaranty Bancshares, Inc.
FGEN - FibroGen, Inc
FGM - First Trust Germany AlphaDEX Fund
FHCO - Female Health Company (The)
FHK - First Trust Hong Kong AlphaDEX Fund
FIBK - First Interstate BancSystem, Inc.
FINL - The Finish Line, Inc.
FISI - Financial Institutions, Inc.
FISV - Fiserv, Inc.
FITB - Fifth Third Bancorp
FITBI - Fifth Third Bancorp
FIVE - Five Below, Inc.
FIVN - Five9, Inc.
FIZZ - National Beverage Corp.
FJP - First Trust Japan AlphaDEX Fund
FKO - First Trust South Korea AlphaDEX Fund
FKU - First Trust United Kingdom AlphaDEX Fund
FLAG - WeatherStorm Forensic Accounting Long Short ETF
FLAT - region
FLDM - Fluidigm Corporation
FLEX - Flextronics International Ltd.
FLIC - The First of Long Island Corporation
FLIR - FLIR Systems, Inc.
FLKS - Flex Pharma, Inc.
FLL - Full House Resorts, Inc.
FLML - Flamel Technologies S.A.
FLN - First Trust Latin America AlphaDEX Fund
FLWS - 1-800 FLOWERS.COM, Inc.
FLXN - Flexion Therapeutics, Inc.
FLXS - Flexsteel Industries, Inc.
FMB - First Trust Managed Municipal ETF
FMBH - First Mid-Illinois Bancshares, Inc.
FMBI - First Midwest Bancorp, Inc.
FMER - FirstMerit Corporation
FMI - Foundation Medicine, Inc.
FMNB - Farmers National Banc Corp.
FNBC - First NBC Bank Holding Company
FNFG - First Niagara Financial Group Inc.
FNGN - Financial Engines, Inc.
FNHC - Federated National Holding Company
FNJN - Finjan Holdings, Inc.
FNLC - First Bancorp, Inc (ME)
FNSR - Finisar Corporation
FNTC - FinTech Acquisition Corp.
FNTCU - FinTech Acquisition Corp.
FNTCW - FinTech Acquisition Corp.
FNWB - First Northwest Bancorp
FOGO - Fogo de Chao, Inc.
FOLD - Amicus Therapeutics, Inc.
FOMX - Foamix Pharmaceuticals Ltd.
FONE - First Trust NASDAQ Smartphone Index Fund
FONR - Fonar Corporation
FORD - Forward Industries, Inc.
FORK - Fuling Global Inc.
FORM - FormFactor, Inc.
FORR - Forrester Research, Inc.
FORTY - Formula Systems (1985) Ltd.
FOSL - Fossil Group, Inc.
FOX - Twenty-First Century Fox, Inc.
FOXA - Twenty-First Century Fox, Inc.
FOXF - Fox Factory Holding Corp.
FPA - First Trust Asia Pacific Ex-Japan AlphaDEX Fund
FPRX - Five Prime Therapeutics, Inc.
FPXI - First Trust International IPO ETF
FRAN - Francesca&#39;s Holdings Corporation
FRBA - First Bank
FRBK - Republic First Bancorp, Inc.
FRED - Fred&#39;s, Inc.
FREE - FreeSeas Inc.
FRGI - Fiesta Restaurant Group, Inc.
FRME - First Merchants Corporation
FRP - FairPoint Communications, Inc.
FRPH - FRP Holdings, Inc.
FRPT - Freshpet, Inc.
FRSH - Papa Murphy&#39;s Holdings, Inc.
FSAM - Fifth Street Asset Management Inc.
FSBK - First South Bancorp Inc
FSBW - FS Bancorp, Inc.
FSC - Fifth Street Finance Corp.
FSCFL - Fifth Street Finance Corp.
FSFG - First Savings Financial Group, Inc.
FSFR - Fifth Street Senior Floating Rate Corp.
FSLR - First Solar, Inc.
FSNN - Fusion Telecommunications International, Inc.
FSTR - L.B. Foster Company
FSV - FirstService Corporation
FSYS - Fuel Systems Solutions, Inc.
FSZ - First Trust Switzerland AlphaDEX Fund
FTAG - First Trust Indxx Global Agriculture ETF
FTCS - First Trust Capital Strength ETF
FTD - FTD Companies, Inc.
FTEK - Fuel Tech, Inc.
FTGC - First Trust Global Tactical Commodity Strategy Fund
FTHI - First Trust High Income ETF
FTLB - First Trust Low Beta Income ETF
FTNT - Fortinet, Inc.
FTR - Frontier Communications Corporation
FTRI - First Trust Indxx Global Natural Resources Income ETF
FTRPR - Frontier Communications Corporation
FTSL - First Trust Senior Loan Fund ETF
FTSM - First Trust Enhanced Short Maturity ETF
FTW - First Trust Taiwan AlphaDEX Fund
FUEL - Rocket Fuel Inc.
FULL - Full Circle Capital Corporation
FULLL - Full Circle Capital Corporation
FULT - Fulton Financial Corporation
FUNC - First United Corporation
FUND - Sprott Focus Trust, Inc.
FV - First Trust Dorsey Wright Focus 5 ETF
FWM - Fairway Group Holdings Corp.
FWP - Forward Pharma A/S
FWRD - Forward Air Corporation
FXCB - Fox Chase Bancorp, Inc.
GABC - German American Bancorp, Inc.
GAI - Global-Tech Advanced Innovations Inc.
GAIA - Gaiam, Inc.
GAIN - Gladstone Investment Corporation
GAINN - Gladstone Investment Corporation
GAINO - Gladstone Investment Corporation
GAINP - Gladstone Investment Corporation
GALE - Galena Biopharma, Inc.
GALT - Galectin Therapeutics Inc.
GALTU - Galectin Therapeutics Inc.
GALTW - Galectin Therapeutics Inc.
GARS - Garrison Capital Inc.
GASS - StealthGas, Inc.
GBCI - Glacier Bancorp, Inc.
GBDC - Golub Capital BDC, Inc.
GBIM - GlobeImmune, Inc.
GBLI - Global Indemnity plc
GBLIZ - Global Indemnity plc
GBNK - Guaranty Bancorp
GBSN - Great Basin Scientific, Inc.
GBT - GLOBAL BLOOD THERAPEUTICS, INC.
GCBC - Greene County Bancorp, Inc.
GCTS - GCT Semiconductor, Inc.
GCVRZ - Sanofi
GDEN - Golden Entertainment, Inc.
GENC - Gencor Industries Inc.
GENE - Genetic Technologies Ltd
GEOS - Geospace Technologies Corporation
GERN - Geron Corporation
GEVO - Gevo, Inc.
GFED - Guaranty Federal Bancshares, Inc.
GFN - General Finance Corporation
GFNCP - General Finance Corporation
GFNSL - General Finance Corporation
GGAC - Garnero Group Acquisition Company
GGACR - Garnero Group Acquisition Company
GGACU - Garnero Group Acquisition Company
GGACW - Garnero Group Acquisition Company
GGAL - Grupo Financiero Galicia S.A.
GHDX - Genomic Health, Inc.
GIFI - Gulf Island Fabrication, Inc.
GIGA - Giga-tronics Incorporated
GIGM - GigaMedia Limited
GIII - G-III Apparel Group, LTD.
GILD - Gilead Sciences, Inc.
GILT - Gilat Satellite Networks Ltd.
GK - G&K Services, Inc.
GLAD - Gladstone Capital Corporation
GLADO - Gladstone Capital Corporation
GLBL - TerraForm Global, Inc.
GLBS - Globus Maritime Limited
GLBZ - Glen Burnie Bancorp
GLDC - Golden Enterprises, Inc.
GLDD - Great Lakes Dredge & Dock Corporation
GLDI - Credit Suisse AG
GLMD - Galmed Pharmaceuticals Ltd.
GLNG - Golar LNG Limited
GLPG - Galapagos NV
GLPI - Gaming and Leisure Properties, Inc.
GLRE - Greenlight Reinsurance, Ltd.
GLRI - Glori Energy Inc
GLSS - Gelesis, Inc.
GLUU - Glu Mobile Inc.
GLYC - GlycoMimetics, Inc.
GMAN - Gordmans Stores, Inc.
GMCR - Keurig Green Mountain, Inc.
GMLP - Golar LNG Partners LP
GNBC - Green Bancorp, Inc.
GNCA - Genocea Biosciences, Inc.
GNCMA - General Communication, Inc.
GNMA - iShares GNMA Bond ETF
GNMK - GenMark Diagnostics, Inc.
GNOW - American Caresource Holdings Inc
GNRX - Market Vectors Generic Drugs ETF
GNST - GenSight Biologics S.A.
GNTX - Gentex Corporation
GNVC - GenVec, Inc.
GOGL - Golden Ocean Group Limited
GOGO - Gogo Inc.
GOLD - Randgold Resources Limited
GOOD - Gladstone Commercial Corporation
GOODN - Gladstone Commercial Corporation
GOODO - Gladstone Commercial Corporation
GOODP - Gladstone Commercial Corporation
GOOG - Alphabet Inc.
GOOGL - Alphabet Inc.
GPAC - Global Partner Acquisition Corp.
GPACU - Global Partner Acquisition Corp.
GPACW - Global Partner Acquisition Corp.
GPIA - GP Investments Acquisition Corp.
GPIAU - GP Investments Acquisition Corp.
GPIAW - GP Investments Acquisition Corp.
GPIC - Gaming Partners International Corporation
GPOR - Gulfport Energy Corporation
GPP - Green Plains Partners LP
GPRE - Green Plains, Inc.
GPRO - GoPro, Inc.
GRBK - Green Brick Partners, Inc.
GRFS - Grifols, S.A.
GRID - First Trust NASDAQ Clean Edge Smart Grid Infrastructure Index
GRIF - Griffin Industrial Realty, Inc.
GRMN - Garmin Ltd.
GROW - U.S. Global Investors, Inc.
GRPN - Groupon, Inc.
GRSH - Gores Holdings, Inc.
GRSHU - Gores Holdings, Inc.
GRSHW - Gores Holdings, Inc.
GRVY - GRAVITY Co., Ltd.
GSBC - Great Southern Bancorp, Inc.
GSIG - GSI Group, Inc.
GSIT - GSI Technology, Inc.
GSM - Ferroglobe PLC
GSOL - Global Sources Ltd.
GSVC - GSV Capital Corp
GT - The Goodyear Tire & Rubber Company
GTIM - Good Times Restaurants Inc.
GTLS - Chart Industries, Inc.
GTWN - Georgetown Bancorp, Inc.
GTXI - GTx, Inc.
GUID - Guidance Software, Inc.
GULF - WisdomTree Middle East Dividend Fund
GURE - Gulf Resources, Inc.
GWGH - GWG Holdings, Inc
GWPH - GW Pharmaceuticals Plc
GYRO - Gyrodyne , LLC
HA - Hawaiian Holdings, Inc.
HABT - The Habit Restaurants, Inc.
HAFC - Hanmi Financial Corporation
HAIN - The Hain Celestial Group, Inc.
HALL - Hallmark Financial Services, Inc.
HALO - Halozyme Therapeutics, Inc.
HART - Harvard Apparatus Regenerative Technology, Inc.
HAS - Hasbro, Inc.
HAWK - Blackhawk Network Holdings, Inc.
HAYN - Haynes International, Inc.
HBAN - Huntington Bancshares Incorporated
HBANP - Huntington Bancshares Incorporated
HBCP - Home Bancorp, Inc.
HBHC - Hancock Holding Company
HBHCL - Hancock Holding Company
HBIO - Harvard Bioscience, Inc.
HBK - Hamilton Bancorp, Inc.
HBMD - Howard Bancorp, Inc.
HBNC - Horizon Bancorp (IN)
HBP - Huttig Building Products, Inc.
HCAC - Hennessy Capital Acquisition Corp. II
HCACU - Hennessy Capital Acquisition Corp. II
HCACW - Hennessy Capital Acquisition Corp. II
HCAP - Harvest Capital Credit Corporation
HCAPL - Harvest Capital Credit Corporation
HCCI - Heritage-Crystal Clean, Inc.
HCKT - The Hackett Group, Inc.
HCOM - Hawaiian Telcom Holdco, Inc.
HCSG - Healthcare Services Group, Inc.
HDNG - Hardinge, Inc.
HDP - Hortonworks, Inc.
HDRA - Hydra Industries Acquisition Corp.
HDRAR - Hydra Industries Acquisition Corp.
HDRAU - Hydra Industries Acquisition Corp.
HDRAW - Hydra Industries Acquisition Corp.
HDS - HD Supply Holdings, Inc.
HDSN - Hudson Technologies, Inc.
HEAR - Turtle Beach Corporation
HEES - H&E Equipment Services, Inc.
HELE - Helen of Troy Limited
HEOP - Heritage Oaks Bancorp
HERO - Hercules Offshore, Inc.
HFBC - HopFed Bancorp, Inc.
HFBL - Home Federal Bancorp, Inc. of Louisiana
HFFC - HF Financial Corp.
HFWA - Heritage Financial Corporation
HGSH - China HGS Real Estate, Inc.
HIBB - Hibbett Sports, Inc.
HIFS - Hingham Institution for Savings
HIHO - Highway Holdings Limited
HIIQ - Health Insurance Innovations, Inc.
HIMX - Himax Technologies, Inc.
HLG - Hailiang Education Group Inc.
HLIT - Harmonic Inc.
HMHC - Houghton Mifflin Harcourt Company
HMIN - Homeinns Hotel Group
HMNF - HMN Financial, Inc.
HMNY - Helios and Matheson Analytics Inc
HMPR - Hampton Roads Bankshares Inc
HMST - HomeStreet, Inc.
HMSY - HMS Holdings Corp
HMTV - Hemisphere Media Group, Inc.
HNH - Handy & Harman Ltd.
HNNA - Hennessy Advisors, Inc.
HNRG - Hallador Energy Company
HNSN - Hansen Medical, Inc.
HOFT - Hooker Furniture Corporation
HOLI - Hollysys Automation Technologies, Ltd.
HOLX - Hologic, Inc.
HOMB - Home BancShares, Inc.
HOTR - Chanticleer Holdings, Inc.
HOTRW - Chanticleer Holdings, Inc.
HOVNP - Hovnanian Enterprises Inc
HPJ - Highpower International Inc
HQCL - Hanwha Q CELLS Co., Ltd.
HQY - HealthEquity, Inc.
HRMN - Harmony Merger Corp.
HRMNU - Harmony Merger Corp.
HRMNW - Harmony Merger Corp.
HRTX - Heron Therapeutics, Inc.
HRZN - Horizon Technology Finance Corporation
HSGX - Histogenics Corporation
HSIC - Henry Schein, Inc.
HSII - Heidrick & Struggles International, Inc.
HSKA - Heska Corporation
HSNI - HSN, Inc.
HSON - Hudson Global, Inc.
HSTM - HealthStream, Inc.
HTBI - HomeTrust Bancshares, Inc.
HTBK - Heritage Commerce Corp
HTBX - Heat Biologics, Inc.
HTCH - Hutchinson Technology Incorporated
HTGM - HTG Molecular Diagnostics, Inc.
HTHT - China Lodging Group, Limited
HTLD - Heartland Express, Inc.
HTLF - Heartland Financial USA, Inc.
HTWR - Heartware International, Inc.
HUBG - Hub Group, Inc.
HURC - Hurco Companies, Inc.
HURN - Huron Consulting Group Inc.
HWAY - Healthways, Inc.
HWBK - Hawthorn Bancshares, Inc.
HWCC - Houston Wire & Cable Company
HWKN - Hawkins, Inc.
HYGS - Hydrogenics Corporation
HYLS - First Trust High Yield Long/Short ETF
HYND - WisdomTree BofA Merrill Lynch High Yield Bond Negative Duratio
HYZD - WisdomTree BofA Merrill Lynch High Yield Bond Zero Duration Fu
HZNP - Horizon Pharma plc
IAC - IAC/InterActiveCorp
IART - Integra LifeSciences Holdings Corporation
IBB - iShares Nasdaq Biotechnology Index Fund
IBCP - Independent Bank Corporation
IBKC - IBERIABANK Corporation
IBKCP - IBERIABANK Corporation
IBKR - Interactive Brokers Group, Inc.
IBOC - International Bancshares Corporation
IBTX - Independent Bank Group, Inc
ICAD - icad inc.
ICBK - County Bancorp, Inc.
ICCC - ImmuCell Corporation
ICFI - ICF International, Inc.
ICLD - InterCloud Systems, Inc
ICLDW - InterCloud Systems, Inc
ICLN - iShares S&P Global Clean Energy Index Fund
ICLR - ICON plc
ICON - Iconix Brand Group, Inc.
ICPT - Intercept Pharmaceuticals, Inc.
ICUI - ICU Medical, Inc.
IDCC - InterDigital, Inc.
IDLB - PowerShares FTSE International Low Beta Equal Weight Portfolio
IDRA - Idera Pharmaceuticals, Inc.
IDSA - Industrial Services of America, Inc.
IDSY - I.D. Systems, Inc.
IDTI - Integrated Device Technology, Inc.
IDXG - Interpace Diagnostics Group, Inc.
IDXX - IDEXX Laboratories, Inc.
IEP - Icahn Enterprises L.P.
IESC - Integrated Electrical Services, Inc.
IEUS - iShares MSCI Europe Small-Cap ETF
IFEU - iShares FTSE EPRA/NAREIT Europe Index Fund
IFGL - iShares FTSE EPRA/NAREIT Global Real Estate ex-U.S. Index Fund
IFON - InfoSonics Corp
IFV - First Trust Dorsey Wright International Focus 5 ETF
IGF - iShares Global Infrastructure ETF
IGLD - Internet Gold Golden Lines Ltd.
IGOV - iShares S&P/Citigroup International Treasury Bond Fund
III - Information Services Group, Inc.
IIIN - Insteel Industries, Inc.
IIJI - Internet Initiative Japan, Inc.
IILG - Interval Leisure Group, Inc.
IIN - IntriCon Corporation
IIVI - II-VI Incorporated
IKGH - Iao Kun Group Holding Company Limited
IKNX - Ikonics Corporation
ILMN - Illumina, Inc.
IMDZ - Immune Design Corp.
IMGN - ImmunoGen, Inc.
IMI - Intermolecular, Inc.
IMKTA - Ingles Markets, Incorporated
IMMR - Immersion Corporation
IMMU - Immunomedics, Inc.
IMMY - Imprimis Pharmaceuticals, Inc.
IMNP - Immune Pharmaceuticals Inc.
IMOS - ChipMOS TECHNOLOGIES (Bermuda) LTD.
INAP - Internap Corporation
INBK - First Internet Bancorp
INCR - INC Research Holdings, Inc.
INCY - Incyte Corporation
INDB - Independent Bank Corp.
INDY - iShares S&P India Nifty 50 Index Fund
INFI - Infinity Pharmaceuticals, Inc.
INFN - Infinera Corporation
INGN - Inogen, Inc
ININ - Interactive Intelligence Group, Inc.
INNL - Innocoll AG
INO - Inovio Pharmaceuticals, Inc.
INOD - Innodata Inc.
INOV - Inovalon Holdings, Inc.
INSM - Insmed, Inc.
INSY - Insys Therapeutics, Inc.
INTC - Intel Corporation
INTG - The Intergroup Corporation
INTL - INTL FCStone Inc.
INTLL - INTL FCStone Inc.
INTU - Intuit Inc.
INTX - Intersections, Inc.
INVA - Innoviva, Inc.
INVE - Identiv, Inc.
INVT - Inventergy Global, Inc.
INWK - InnerWorkings, Inc.
IONS - Ionis Pharmaceuticals, Inc.
IOSP - Innospec Inc.
IOTS - Adesto Technologies Corporation
IPAR - Inter Parfums, Inc.
IPAS - iPass Inc.
IPCC - Infinity Property and Casualty Corporation
IPCI - Intellipharmaceutics International Inc.
IPDN - Professional Diversity Network, Inc.
IPGP - IPG Photonics Corporation
IPHS - Innophos Holdings, Inc.
IPKW - PowerShares International BuyBack Achievers Portfolio
IPWR - Ideal Power Inc.
IPXL - Impax Laboratories, Inc.
IQNT - Inteliquent, Inc.
IRBT - iRobot Corporation
IRCP - IRSA Propiedades Comerciales S.A.
IRDM - Iridium Communications Inc
IRDMB - Iridium Communications Inc
IRG - Ignite Restaurant Group, Inc.
IRIX - IRIDEX Corporation
IRMD - iRadimed Corporation
IROQ - IF Bancorp, Inc.
IRWD - Ironwood Pharmaceuticals, Inc.
ISBC - Investors Bancorp, Inc.
ISCA - International Speedway Corporation
ISHG - iShares S&P/Citigroup 1-3 Year International Treasury Bond Fun
ISIG - Insignia Systems, Inc.
ISIL - Intersil Corporation
ISLE - Isle of Capri Casinos, Inc.
ISM - SLM Corporation
ISNS - Image Sensing Systems, Inc.
ISRG - Intuitive Surgical, Inc.
ISRL - Isramco, Inc.
ISSC - Innovative Solutions and Support, Inc.
ISTR - Investar Holding Corporation
ITCI - Intra-Cellular Therapies Inc.
ITEK - Inotek Pharmaceuticals Corporation
ITEQ - BlueStar TA-BIGITech Israel Technology ETF
ITI - Iteris, Inc.
ITIC - Investors Title Company
ITRI - Itron, Inc.
ITRN - Ituran Location and Control Ltd.
ITUS - ITUS Corporation
IVAC - Intevac, Inc.
IVTY - Invuity, Inc.
IXUS - iShares Core MSCI Total International Stock ETF
IXYS - IXYS Corporation
JACK - Jack In The Box Inc.
JAGX - Jaguar Animal Health, Inc.
JAKK - JAKKS Pacific, Inc.
JASN - Jason Industries, Inc.
JASNW - Jason Industries, Inc.
JASO - JA Solar Holdings, Co., Ltd.
JAXB - Jacksonville Bancorp, Inc.
JAZZ - Jazz Pharmaceuticals plc
JBHT - J.B. Hunt Transport Services, Inc.
JBLU - JetBlue Airways Corporation
JBSS - John B. Sanfilippo & Son, Inc.
JCOM - j2 Global, Inc.
JCS - Communications Systems, Inc.
JCTCF - Jewett-Cameron Trading Company
JD - JD.com, Inc.
JGBB - WisdomTree Japan Interest Rate Strategy Fund
JIVE - Jive Software, Inc.
JJSF - J & J Snack Foods Corp.
JKHY - Jack Henry & Associates, Inc.
JKI - iShares Morningstar Mid-Cap ETF
JMBA - Jamba, Inc.
JNP - Juniper Pharmaceuticals, Inc.
JOBS - 51job, Inc.
JOUT - Johnson Outdoors Inc.
JRJC - China Finance Online Co. Limited
JRVR - James River Group Holdings, Ltd.
JSM - SLM Corporation
JST - Jinpan International Limited
JTPY - JetPay Corporation
JUNO - Juno Therapeutics, Inc.
JVA - Coffee Holding Co., Inc.
JXSB - Jacksonville Bancorp Inc.
JYNT - The Joint Corp.
KALU - Kaiser Aluminum Corporation
KANG - iKang Healthcare Group, Inc.
KBAL - Kimball International, Inc.
KBSF - KBS Fashion Group Limited
KCAP - KCAP Financial, Inc.
KE - Kimball Electronics, Inc.
KELYA - Kelly Services, Inc.
KELYB - Kelly Services, Inc.
KEQU - Kewaunee Scientific Corporation
KERX - Keryx Biopharmaceuticals, Inc.
KEYW - The KEYW Holding Corporation
KFFB - Kentucky First Federal Bancorp
KFRC - Kforce, Inc.
KGJI - Kingold Jewelry Inc.
KHC - The Kraft Heinz Company
KIN - Kindred Biosciences, Inc.
KINS - Kingstone Companies, Inc
KIRK - Kirkland&#39;s, Inc.
KITE - Kite Pharma, Inc.
KLAC - KLA-Tencor Corporation
KLIC - Kulicke and Soffa Industries, Inc.
KLOX - Klox Technologies Inc.
KLRE - KLR Energy Acquisition Corp.
KLREU - KLR Energy Acquisition Corp.
KLXI - KLX Inc.
KMDA - Kamada Ltd.
KMPH - KemPharm, Inc.
KNDI - Kandi Technologies Group, Inc.
KONA - Kona Grill, Inc.
KONE - Kingtone Wirelessinfo Solution Holding Ltd
KOOL - Cesca Therapeutics Inc.
KOPN - Kopin Corporation
KOSS - Koss Corporation
KPTI - Karyopharm Therapeutics Inc.
KRNT - Kornit Digital Ltd.
KRNY - Kearny Financial
KTCC - Key Tronic Corporation
KTEC - Key Technology, Inc.
KTOS - Kratos Defense & Security Solutions, Inc.
KTOV - Kitov Pharamceuticals Holdings Ltd.
KTOVW - Kitov Pharamceuticals Holdings Ltd.
KTWO - K2M Group Holdings, Inc.
KURA - Kura Oncology, Inc.
KUTV - Ku6 Media Co., Ltd.
KVHI - KVH Industries, Inc.
KWEB - KraneShares CSI China Internet ETF
KZ - KongZhong Corporation
LABL - Multi-Color Corporation
LAKE - Lakeland Industries, Inc.
LALT - PowerShares Multi-Strategy Alternative Portfolio
LAMR - Lamar Advertising Company
LANC - Lancaster Colony Corporation
LAND - Gladstone Land Corporation
LARK - Landmark Bancorp Inc.
LAWS - Lawson Products, Inc.
LAYN - Layne Christensen Company
LBAI - Lakeland Bancorp, Inc.
LBIO - Lion Biotechnologies, Inc.
LBIX - Leading Brands Inc
LBRDA - Liberty Broadband Corporation
LBRDK - Liberty Broadband Corporation
LBTYA - Liberty Global plc
LBTYB - Liberty Global plc
LBTYK - Liberty Global plc
LCNB - LCNB Corporation
LCUT - Lifetime Brands, Inc.
LDRH - LDR Holding Corporation
LDRI - PowerShares LadderRite 0-5 Year Corporate Bond Portfolio
LE - Lands&#39; End, Inc.
LECO - Lincoln Electric Holdings, Inc.
LEDS - SemiLEDS Corporation
LENS - Presbia PLC
LFUS - Littelfuse, Inc.
LFVN - Lifevantage Corporation
LGCY - Legacy Reserves LP
LGCYO - Legacy Reserves LP
LGCYP - Legacy Reserves LP
LGIH - LGI Homes, Inc.
LGND - Ligand Pharmaceuticals Incorporated
LHCG - LHC Group
LIFE - aTyr Pharma, Inc.
LILA - Liberty Global plc
LILAK - Liberty Global plc
LIME - Lime Energy Co.
LINC - Lincoln Educational Services Corporation
LIND - Lindblad Expeditions Holdings Inc.
LINDW - Lindblad Expeditions Holdings Inc.
LINE - Linn Energy, LLC
LION - Fidelity Southern Corporation
LIOX - Lionbridge Technologies, Inc.
LITE - Lumentum Holdings Inc.
LIVE - Live Ventures Incorporated
LIVN - LivaNova PLC
LJPC - La Jolla Pharmaceutical Company
LKFN - Lakeland Financial Corporation
LKOR - FlexShares Credit-Scored US Long Corporate Bond Index Fund
LKQ - LKQ Corporation
LLEX - Lilis Energy, Inc.
LLNW - Limelight Networks, Inc.
LLTC - Linear Technology Corporation
LMAT - LeMaitre Vascular, Inc.
LMBS - First Trust Low Duration Mortgage Opportunities ETF
LMCA - Liberty Media Corporation
LMCB - Liberty Media Corporation
LMCK - Liberty Media Corporation
LMFA - LM Funding America, Inc.
LMFAW - LM Funding America, Inc.
LMIA - LMI Aerospace, Inc.
LMNR - Limoneira Co
LMNX - Luminex Corporation
LMOS - Lumos Networks Corp.
LMRK - Landmark Infrastructure Partners LP
LNCE - Snyder&#39;s-Lance, Inc.
LNCO - Linn Co, LLC
LNDC - Landec Corporation
LNTH - Lantheus Holdings, Inc.
LOAN - Manhattan Bridge Capital, Inc
LOB - Live Oak Bancshares, Inc.
LOCO - El Pollo Loco Holdings, Inc.
LOGI - Logitech International S.A.
LOGM - LogMein, Inc.
LOJN - LoJack Corporation
LONG - eLong, Inc.
LOPE - Grand Canyon Education, Inc.
LORL - Loral Space and Communications, Inc.
LOXO - Loxo Oncology, Inc.
LPCN - Lipocine Inc.
LPLA - LPL Financial Holdings Inc.
LPNT - LifePoint Health, Inc.
LPSB - LaPorte Bancorp, Inc.
LPSN - LivePerson, Inc.
LPTH - LightPath Technologies, Inc.
LPTN - Lpath, Inc.
LQDT - Liquidity Services, Inc.
LRAD - LRAD Corporation
LRCX - Lam Research Corporation
LSBG - Lake Sunapee Bank Group
LSBK - Lake Shore Bancorp, Inc.
LSCC - Lattice Semiconductor Corporation
LSTR - Landstar System, Inc.
LTBR - Lightbridge Corporation
LTRPA - Liberty TripAdvisor Holdings, Inc.
LTRPB - Liberty TripAdvisor Holdings, Inc.
LTRX - Lantronix, Inc.
LTXB - LegacyTexas Financial Group, Inc.
LULU - lululemon athletica inc.
LUNA - Luna Innovations Incorporated
LVHD - Legg Mason Low Volatility High Dividend ETF
LVNTA - Liberty Interactive Corporation
LVNTB - Liberty Interactive Corporation
LWAY - Lifeway Foods, Inc.
LXRX - Lexicon Pharmaceuticals, Inc.
LYTS - LSI Industries Inc.
MACK - Merrimack Pharmaceuticals, Inc.
MAGS - Magal Security Systems Ltd.
MAMS - MAM Software Group, Inc.
MANH - Manhattan Associates, Inc.
MANT - ManTech International Corporation
MAPI - Mapi - Pharma Ltd.
MAR - Marriott International
MARA - Marathon Patent Group, Inc.
MARK - Remark Media, Inc.
MARPS - Marine Petroleum Trust
MASI - Masimo Corporation
MAT - Mattel, Inc.
MATR - Mattersight Corporation
MATW - Matthews International Corporation
MAUI - AdvisorShares Market Adaptive Unconstrained Income ETF
MAYS - J. W. Mays, Inc.
MB - MINDBODY, Inc.
MBCN - Middlefield Banc Corp.
MBFI - MB Financial Inc.
MBFIP - MB Financial Inc.
MBII - Marrone Bio Innovations, Inc.
MBLX - Metabolix, Inc.
MBRG - Middleburg Financial Corporation
MBSD - FlexShares Disciplined Duration MBS Index Fund
MBTF - M B T Financial Corp
MBUU - Malibu Boats, Inc.
MBVT - Merchants Bancshares, Inc.
MBWM - Mercantile Bank Corporation
MCBC - Macatawa Bank Corporation
MCEP - Mid-Con Energy Partners, LP
MCFT - MCBC Holdings, Inc.
MCHI - iShares MSCI China ETF
MCHP - Microchip Technology Incorporated
MCHX - Marchex, Inc.
MCOX - Mecox Lane Limited
MCRB - Seres Therapeutics, Inc.
MCRI - Monarch Casino & Resort, Inc.
MCUR - MACROCURE LTD.
MDCA - MDC Partners Inc.
MDCO - The Medicines Company
MDGS - Medigus Ltd.
MDIV - First Trust Multi-Asset Diversified Income Index Fund
MDLZ - Mondelez International, Inc.
MDM - Mountain Province Diamonds Inc.
MDRX - Allscripts Healthcare Solutions, Inc.
MDSO - Medidata Solutions, Inc.
MDSY - ModSys International Ltd.
MDVN - Medivation, Inc.
MDVX - Medovex Corp.
MDVXW - Medovex Corp.
MDWD - MediWound Ltd.
MDXG - MiMedx Group, Inc
MEET - MeetMe, Inc.
MEIP - MEI Pharma, Inc.
MELI - MercadoLibre, Inc.
MELR - Melrose Bancorp, Inc.
MEMP - Memorial Production Partners LP
MENT - Mentor Graphics Corporation
MEOH - Methanex Corporation
MERC - Mercer International Inc.
MESG - Xura, Inc.
MESO - Mesoblast Limited
MFLX - Multi-Fineline Electronix, Inc.
MFNC - Mackinac Financial Corporation
MFRI - MFRI, Inc.
MFRM - Mattress Firm Holding Corp.
MFSF - MutualFirst Financial Inc.
MGCD - MGC Diagnostics Corporation
MGEE - MGE Energy Inc.
MGI - Moneygram International, Inc.
MGIC - Magic Software Enterprises Ltd.
MGLN - Magellan Health, Inc.
MGNX - MacroGenics, Inc.
MGPI - MGP Ingredients, Inc.
MGRC - McGrath RentCorp
MGYR - Magyar Bancorp, Inc.
MHGC - Morgans Hotel Group Co.
MHLD - Maiden Holdings, Ltd.
MHLDO - Maiden Holdings, Ltd.
MICT - Micronet Enertec Technologies, Inc.
MICTW - Micronet Enertec Technologies, Inc.
MIDD - The Middleby Corporation
MIFI - Novatel Wireless, Inc.
MIK - The Michaels Companies, Inc.
MIME - Mimecast Limited
MIND - Mitcham Industries, Inc.
MINI - Mobile Mini, Inc.
MIRN - Mirna Therapeutics, Inc.
MITK - Mitek Systems, Inc.
MITL - Mitel Networks Corporation
MKSI - MKS Instruments, Inc.
MKTO - Marketo, Inc.
MKTX - MarketAxess Holdings, Inc.
MLAB - Mesa Laboratories, Inc.
MLHR - Herman Miller, Inc.
MLNK - ModusLink Global Solutions, Inc
MLNX - Mellanox Technologies, Ltd.
MLVF - Malvern Bancorp, Inc.
MMAC - MMA Capital Management, LLC
MMLP - Martin Midstream Partners L.P.
MMSI - Merit Medical Systems, Inc.
MMYT - MakeMyTrip Limited
MNDO - MIND C.T.I. Ltd.
MNGA - MagneGas Corporation
MNKD - MannKind Corporation
MNOV - MediciNova, Inc.
MNRK - Monarch Financial Holdings, Inc.
MNRO - Monro Muffler Brake, Inc.
MNST - Monster Beverage Corporation
MNTA - Momenta Pharmaceuticals, Inc.
MNTX - Manitex International, Inc.
MOBI - Sky-mobi Limited
MOBL - MobileIron, Inc.
MOCO - MOCON, Inc.
MOFG - MidWestOne Financial Group, Inc.
MOKO - Moko Social Media Ltd.
MOLG - MOL Global, Inc.
MOMO - Momo Inc.
MORN - Morningstar, Inc.
MOSY - MoSys, Inc.
MPAA - Motorcar Parts of America, Inc.
MPB - Mid Penn Bancorp
MPEL - Melco Crown Entertainment Limited
MPET - Magellan Petroleum Corporation
MPWR - Monolithic Power Systems, Inc.
MRCC - Monroe Capital Corporation
MRCY - Mercury Systems Inc
MRD - Memorial Resource Development Corp.
MRKT - Markit Ltd.
MRLN - Marlin Business Services Corp.
MRNS - Marinus Pharmaceuticals, Inc.
MRTN - Marten Transport, Ltd.
MRTX - Mirati Therapeutics, Inc.
MRVC - MRV Communications, Inc.
MRVL - Marvell Technology Group Ltd.
MSBF - MSB Financial Corp.
MSCC - Microsemi Corporation
MSEX - Middlesex Water Company
MSFG - MainSource Financial Group, Inc.
MSFT - Microsoft Corporation
MSG - MSG Networks Inc.
MSLI - Merus Labs International Inc.
MSON - MISONIX, Inc.
MSTR - MicroStrategy Incorporated
MTBC - Medical Transcription Billing, Corp.
MTBCP - Medical Transcription Billing, Corp.
MTCH - Match Group, Inc.
MTEX - Mannatech, Incorporated
MTGE - American Capital Mortgage Investment Corp.
MTGEP - American Capital Mortgage Investment Corp.
MTLS - Materialise NV
MTP - Midatech Pharma PLC
MTRX - Matrix Service Company
MTSC - MTS Systems Corporation
MTSI - M/A-COM Technology Solutions Holdings, Inc.
MTSL - MER Telemanagement Solutions Ltd.
MTSN - Mattson Technology, Inc.
MU - Micron Technology, Inc.
MVIS - Microvision, Inc.
MXIM - Maxim Integrated Products, Inc.
MXWL - Maxwell Technologies, Inc.
MYGN - Myriad Genetics, Inc.
MYL - Mylan N.V.
MYOK - MyoKardia, Inc.
MYOS - MYOS Corporation
MYRG - MYR Group, Inc.
MZOR - Mazor Robotics Ltd.
NAII - Natural Alternatives International, Inc.
NAKD - Naked Brand Group Inc.
NAME - Rightside Group, Ltd.
NANO - Nanometrics Incorporated
NATH - Nathan&#39;s Famous, Inc.
NATI - National Instruments Corporation
NATL - National Interstate Corporation
NATR - Nature&#39;s Sunshine Products, Inc.
NAUH - National American University Holdings, Inc.
NAVG - The Navigators Group, Inc.
NAVI - Navient Corporation
NBBC - NewBridge Bancorp
NBCP - NB Capital Acquisition Corp.
NBIX - Neurocrine Biosciences, Inc.
NBN - Northeast Bancorp
NBRV - Nabriva Therapeutics AG
NBTB - NBT Bancorp Inc.
NCIT - NCI, Inc.
NCLH - Norwegian Cruise Line Holdings Ltd.
NCMI - National CineMedia, Inc.
NCOM - National Commerce Corporation
NCTY - The9 Limited
NDAQ - Nasdaq, Inc.
NDLS - Noodles & Company
NDRM - NeuroDerm Ltd.
NDSN - Nordson Corporation
NEO - NeoGenomics, Inc.
NEOG - Neogen Corporation
NEON - Neonode Inc.
NEOS - Neos Therapeutics, Inc.
NEOT - Neothetics, Inc.
NEPT - Neptune Technologies & Bioresources Inc
NERV - Minerva Neurosciences, Inc
NETE - Net Element, Inc.
NEWP - Newport Corporation
NEWS - NewStar Financial, Inc.
NEWT - Newtek Business Services Corp.
NEWTZ - Newtek Business Services Corp.
NFBK - Northfield Bancorp, Inc.
NFEC - NF Energy Saving Corporation
NFLX - Netflix, Inc.
NGHC - National General Holdings Corp
NGHCO - National General Holdings Corp
NGHCP - National General Holdings Corp
NGHCZ - National General Holdings Corp
NHLD - National Holdings Corporation
NHTC - Natural Health Trends Corp.
NICE - NICE-Systems Limited
NICK - Nicholas Financial, Inc.
NIHD - NII Holdings, Inc.
NILE - Blue Nile, Inc.
NK - NantKwest, Inc.
NKSH - National Bankshares, Inc.
NKTR - Nektar Therapeutics
NLNK - NewLink Genetics Corporation
NLST - Netlist, Inc.
NMIH - NMI Holdings Inc
NMRX - Numerex Corp.
NNBR - NN, Inc.
NORT - Nordic Realty Trust, Inc.
NPBC - National Penn Bancshares, Inc.
NRCIA - National Research Corporation
NRCIB - National Research Corporation
NRIM - Northrim BanCorp Inc
NRX - NephroGenex, Inc.
NSEC - National Security Group, Inc.
NSIG - NeuroSigma, Inc.
NSIT - Insight Enterprises, Inc.
NSPH - Nanosphere, Inc.
NSSC - NAPCO Security Technologies, Inc.
NSTG - NanoString Technologies, Inc.
NSYS - Nortech Systems Incorporated
NTAP - NetApp, Inc.
NTCT - NetScout Systems, Inc.
NTEC - Intec Pharma Ltd.
NTES - NetEase, Inc.
NTGR - NETGEAR, Inc.
NTIC - Northern Technologies International Corporation
NTK - Nortek Inc.
NTLS - NTELOS Holdings Corp.
NTRA - Natera, Inc.
NTRI - NutriSystem Inc
NTRS - Northern Trust Corporation
NTRSP - Northern Trust Corporation
NTWK - NetSol Technologies Inc.
NUAN - Nuance Communications, Inc.
NURO - NeuroMetrix, Inc.
NUROW - NeuroMetrix, Inc.
NUTR - Nutraceutical International Corporation
NUVA - NuVasive, Inc.
NVAX - Novavax, Inc.
NVCN - Neovasc Inc.
NVCR - NovoCure Limited
NVDA - NVIDIA Corporation
NVDQ - Novadaq Technologies Inc
NVEC - NVE Corporation
NVEE - NV5 Global, Inc.
NVET - Nexvet Biopharma plc
NVFY - Nova Lifestyle, Inc
NVGN - Novogen Limited
NVIV - InVivo Therapeutics Holdings Corp.
NVLS - Nivalis Therapeutics, Inc.
NVMI - Nova Measuring Instruments Ltd.
NWBI - Northwest Bancshares, Inc.
NWBO - Northwest Biotherapeutics, Inc.
NWBOW - Northwest Biotherapeutics, Inc.
NWFL - Norwood Financial Corp.
NWLI - National Western Life Group, Inc.
NWPX - Northwest Pipe Company
NWS - News Corporation
NWSA - News Corporation
NXPI - NXP Semiconductors N.V.
NXST - Nexstar Broadcasting Group, Inc.
NXTD - NXT-ID Inc.
NXTDW - NXT-ID Inc.
NXTM - NxStage Medical, Inc.
NYMT - New York Mortgage Trust, Inc.
NYMTO - New York Mortgage Trust, Inc.
NYMTP - New York Mortgage Trust, Inc.
NYMX - Nymox Pharmaceutical Corporation
NYNY - Empire Resorts, Inc.
OASM - Oasmia Pharmaceutical AB
OBAS - Optibase Ltd.
OBCI - Ocean Bio-Chem, Inc.
OCC - Optical Cable Corporation
OCFC - OceanFirst Financial Corp.
OCLR - Oclaro, Inc.
OCLS - Oculus Innovative Sciences, Inc.
OCLSW - Oculus Innovative Sciences, Inc.
OCRX - Ocera Therapeutics, Inc.
OCUL - Ocular Therapeutix, Inc.
ODFL - Old Dominion Freight Line, Inc.
ODP - Office Depot, Inc.
OESX - Orion Energy Systems, Inc.
OFED - Oconee Federal Financial Corp.
OFIX - Orthofix International N.V.
OFLX - Omega Flex, Inc.
OFS - OFS Capital Corporation
OGXI - OncoGenex Pharmaceuticals Inc.
OHAI - OHA Investment Corporation
OHGI - One Horizon Group, Inc.
OHRP - Ohr Pharmaceuticals, Inc.
OIIM - O2Micro International Limited
OKSB - Southwest Bancorp, Inc.
OLBK - Old Line Bancshares, Inc.
OLED - Universal Display Corporation
OLLI - Ollie&#39;s Bargain Outlet Holdings, Inc.
OMAB - Grupo Aeroportuario del Centro Norte S.A.B. de C.V.
OMCL - Omnicell, Inc.
OMED - OncoMed Pharmaceuticals, Inc.
OMER - Omeros Corporation
OMEX - Odyssey Marine Exploration, Inc.
ON - ON Semiconductor Corporation
ONB - Old National Bancorp
ONCE - Spark Therapeutics, Inc.
ONCS - OncoSec Medical Incorporated
ONEQ - Fidelity Nasdaq Composite Index Tracking Stock
ONTX - Onconova Therapeutics, Inc.
ONTY - Oncothyreon Inc.
ONVI - Onvia, Inc.
OPB - Opus Bank
OPGN - OpGen, Inc.
OPGNW - OpGen, Inc.
OPHC - OptimumBank Holdings, Inc.
OPHT - Ophthotech Corporation
OPOF - Old Point Financial Corporation
OPTT - Ocean Power Technologies, Inc.
OPXA - Opexa Therapeutics, Inc.
OPXAW - Opexa Therapeutics, Inc.
ORBC - ORBCOMM Inc.
ORBK - Orbotech Ltd.
OREX - Orexigen Therapeutics, Inc.
ORIG - Ocean Rig UDW Inc.
ORIT - Oritani Financial Corp.
ORLY - O&#39;Reilly Automotive, Inc.
ORMP - Oramed Pharmaceuticals Inc.
ORPN - Bio Blast Pharma Ltd.
ORRF - Orrstown Financial Services Inc
OSBC - Old Second Bancorp, Inc.
OSBCP - Old Second Bancorp, Inc.
OSHC - Ocean Shore Holding Co.
OSIR - Osiris Therapeutics, Inc.
OSIS - OSI Systems, Inc.
OSM - SLM Corporation
OSN - Ossen Innovation Co., Ltd.
OSTK - Overstock.com, Inc.
OSUR - OraSure Technologies, Inc.
OTEL - Otelco Inc.
OTEX - Open Text Corporation
OTG - OTG EXP, Inc.
OTIC - Otonomy, Inc.
OTIV - On Track Innovations Ltd
OTTR - Otter Tail Corporation
OUTR - Outerwall Inc.
OVAS - Ovascience Inc.
OVBC - Ohio Valley Banc Corp.
OVLY - Oak Valley Bancorp (CA)
OXBR - Oxbridge Re Holdings Limited
OXBRW - Oxbridge Re Holdings Limited
OXFD - Oxford Immunotec Global PLC
OXGN - OXiGENE, Inc.
OXLC - Oxford Lane Capital Corp.
OXLCN - Oxford Lane Capital Corp.
OXLCO - Oxford Lane Capital Corp.
OZRK - Bank of the Ozarks
PAAC - Pacific Special Acquisition Corp.
PAACR - Pacific Special Acquisition Corp.
PAACU - Pacific Special Acquisition Corp.
PAACW - Pacific Special Acquisition Corp.
PAAS - Pan American Silver Corp.
PACB - Pacific Biosciences of California, Inc.
PACE - Pace Holdings Corp.
PACEU - Pace Holdings Corp.
PACEW - Pace Holdings Corp.
PACW - PacWest Bancorp
PAGG - PowerShares Global Agriculture Portfolio
PAHC - Phibro Animal Health Corporation
PANL - Pangaea Logistics Solutions Ltd.
PARN - Parnell Pharmaceuticals Holdings Ltd
PATI - Patriot Transportation Holding, Inc.
PATK - Patrick Industries, Inc.
PAYX - Paychex, Inc.
PBBI - PB Bancorp, Inc.
PBCT - People&#39;s United Financial, Inc.
PBHC - Pathfinder Bancorp, Inc.
PBIB - Porter Bancorp, Inc.
PBIP - Prudential Bancorp, Inc.
PBMD - Prima BioMed Ltd
PBPB - Potbelly Corporation
PBSK - Poage Bankshares, Inc.
PCAR - PACCAR Inc.
PCBK - Pacific Continental Corporation (Ore)
PCCC - PC Connection, Inc.
PCH - Potlatch Corporation
PCLN - The Priceline Group Inc.
PCMI - PCM, Inc.
PCO - Pendrell Corporation
PCOM - Points International, Ltd.
PCRX - Pacira Pharmaceuticals, Inc.
PCTI - PC-Tel, Inc.
PCTY - Paylocity Holding Corporation
PCYG - Park City Group, Inc.
PCYO - Pure Cycle Corporation
PDBC - PowerShares DB Optimum Yield Diversified Commodity Strategy Po
PDCE - PDC Energy, Inc.
PDCO - Patterson Companies, Inc.
PDEX - Pro-Dex, Inc.
PDFS - PDF Solutions, Inc.
PDLI - PDL BioPharma, Inc.
PDVW - pdvWireless, Inc.
PEBK - Peoples Bancorp of North Carolina, Inc.
PEBO - Peoples Bancorp Inc.
PEGA - Pegasystems Inc.
PEGI - Pattern Energy Group Inc.
PEIX - Pacific Ethanol, Inc.
PENN - Penn National Gaming, Inc.
PERF - Perfumania Holdings, Inc
PERI - Perion Network Ltd
PERY - Perry Ellis International Inc.
PESI - Perma-Fix Environmental Services, Inc.
PETS - PetMed Express, Inc.
PETX - Aratana Therapeutics, Inc.
PFBC - Preferred Bank
PFBI - Premier Financial Bancorp, Inc.
PFBX - Peoples Financial Corporation
PFIE - Profire Energy, Inc.
PFIN - P & F Industries, Inc.
PFIS - Peoples Financial Services Corp.
PFLT - PennantPark Floating Rate Capital Ltd.
PFMT - Performant Financial Corporation
PFPT - Proofpoint, Inc.
PFSW - PFSweb, Inc.
PGC - Peapack-Gladstone Financial Corporation
PGLC - Pershing Gold Corporation
PGNX - Progenics Pharmaceuticals Inc.
PGTI - PGT, Inc.
PHII - PHI, Inc.
PHIIK - PHI, Inc.
PHMD - PhotoMedex, Inc.
PICO - PICO Holdings Inc.
PIH - 1347 Property Insurance Holdings, Inc.
PINC - Premier, Inc.
PIRS - Pieris Pharmaceuticals, Inc.
PKBK - Parke Bancorp, Inc.
PKOH - Park-Ohio Holdings Corp.
PLAB - Photronics, Inc.
PLAY - Dave & Buster&#39;s Entertainment, Inc.
PLBC - Plumas Bancorp
PLCE - Children&#39;s Place, Inc. (The)
PLCM - Polycom, Inc.
PLKI - Popeyes Louisiana Kitchen, Inc.
PLPC - Preformed Line Products Company
PLPM - Planet Payment, Inc.
PLUG - Plug Power, Inc.
PLUS - ePlus inc.
PLXP - PLx Pharma Inc.
PLXS - Plexus Corp.
PMBC - Pacific Mercantile Bancorp
PMD - Psychemedics Corporation
PME - Pingtan Marine Enterprise Ltd.
PMTS - CPI Card Group Inc.
PMV - PMV Acquisition Corp.
PNBK - Patriot National Bancorp Inc.
PNFP - Pinnacle Financial Partners, Inc.
PNK - Pinnacle Entertainment, Inc.
PNNT - PennantPark Investment Corporation
PNQI - PowerShares Nasdaq Internet Portfolio
PNRA - Panera Bread Company
PNRG - PrimeEnergy Corporation
PNTR - Pointer Telocation Ltd.
PODD - Insulet Corporation
POOL - Pool Corporation
POPE - Pope Resources
POWI - Power Integrations, Inc.
POWL - Powell Industries, Inc.
PPBI - Pacific Premier Bancorp Inc
PPC - Pilgrim&#39;s Pride Corporation
PPH - Market Vectors Pharmaceutical ETF
PPHM - Peregrine Pharmaceuticals Inc.
PPHMP - Peregrine Pharmaceuticals Inc.
PPSI - Pioneer Power Solutions, Inc.
PRAA - PRA Group, Inc.
PRAH - PRA Health Sciences, Inc.
PRAN - Prana Biotechnology Ltd
PRCP - Perceptron, Inc.
PRFT - Perficient, Inc.
PRFZ - PowerShares FTSE RAFI US 1500 Small-Mid Portfolio
PRGN - Paragon Shipping Inc.
PRGNL - Paragon Shipping Inc.
PRGS - Progress Software Corporation
PRGX - PRGX Global, Inc.
PRIM - Primoris Services Corporation
PRKR - ParkerVision, Inc.
PRMW - Primo Water Corporation
PROV - Provident Financial Holdings, Inc.
PRPH - ProPhase Labs, Inc.
PRQR - ProQR Therapeutics N.V.
PRSC - The Providence Service Corporation
PRSS - CafePress Inc.
PRTA - Prothena Corporation plc
PRTK - Paratek Pharmaceuticals, Inc.
PRTO - Proteon Therapeutics, Inc.
PRTS - U.S. Auto Parts Network, Inc.
PRXL - PAREXEL International Corporation
PRZM - Prism Technologies Group, Inc.
PSAU - PowerShares Global Gold & Precious Metals Portfolio
PSCC - PowerShares S&P SmallCap Consumer Staples Portfolio
PSCD - PowerShares S&P SmallCap Consumer Discretionary Portfolio
PSCE - PowerShares S&P SmallCap Energy Portfolio
PSCF - PowerShares S&P SmallCap Financials Portfolio
PSCH - PowerShares S&P SmallCap Health Care Portfolio
PSCI - PowerShares S&P SmallCap Industrials Portfolio
PSCM - PowerShares S&P SmallCap Materials Portfolio
PSCT - PowerShares S&P SmallCap Information Technology Portfolio
PSCU - PowerShares S&P SmallCap Utilities Portfolio
PSDV - pSivida Corp.
PSEC - Prospect Capital Corporation
PSIX - Power Solutions International, Inc.
PSMT - PriceSmart, Inc.
PSTB - Park Sterling Corporation
PSTI - Pluristem Therapeutics, Inc.
PSUN - Pacific Sunwear of California, Inc.
PTC - PTC Inc.
PTCT - PTC Therapeutics, Inc.
PTEN - Patterson-UTI Energy, Inc.
PTI - Proteostasis Therapeutics, Inc.
PTIE - Pain Therapeutics
PTLA - Portola Pharmaceuticals, Inc.
PTNR - Partner Communications Company Ltd.
PTSI - P.A.M. Transportation Services, Inc.
PTX - Pernix Therapeutics Holdings, Inc.
PTXP - PennTex Midstream Partners, LP
PUB - People&#39;s Utah Bancorp
PULB - Pulaski Financial Corp.
PULM - Pulmatrix, Inc.
PUMP - Asante Solutions, Inc.
PVBC - Provident Bancorp, Inc.
PVTB - PrivateBancorp, Inc.
PVTBP - PrivateBancorp, Inc.
PWOD - Penns Woods Bancorp, Inc.
PWX - Providence and Worcester Railroad Company
PXLW - Pixelworks, Inc.
PXS - Pyxis Tankers Inc.
PYDS - Payment Data Systems, Inc.
PYPL - PayPal Holdings, Inc.
PZZA - Papa John&#39;S International, Inc.
QABA - First Trust NASDAQ ABA Community Bank Index Fund
QADA - QAD Inc.
QADB - QAD Inc.
QAT - iShares MSCI Qatar Capped ETF
QBAK - Qualstar Corporation
QCLN - First Trust NASDAQ Clean Edge Green Energy Index Fund
QCOM - QUALCOMM Incorporated
QCRH - QCR Holdings, Inc.
QDEL - Quidel Corporation
QGEN - Qiagen N.V.
QINC - First Trust RBA Quality Income ETF
QIWI - QIWI plc
QKLS - QKL Stores, Inc.
QLC - FlexShares US Quality Large Cap Index Fund
QLGC - QLogic Corporation
QLIK - Qlik Technologies Inc.
QLTI - QLT Inc.
QLYS - Qualys, Inc.
QNST - QuinStreet, Inc.
QPAC - Quinpario Acquisition Corp. 2
QPACU - Quinpario Acquisition Corp. 2
QPACW - Quinpario Acquisition Corp. 2
QQEW - First Trust NASDAQ-100 Equal Weighted Index Fund
QQQ - PowerShares QQQ Trust, Series 1
QQQC - Global X NASDAQ China Technology ETF
QQQX - Nuveen NASDAQ 100 Dynamic Overwrite Fund
QQXT - First Trust NASDAQ-100 Ex-Technology Sector Index Fund
QRHC - Quest Resource Holding Corporation.
QRVO - Qorvo, Inc.
QSII - Quality Systems, Inc.
QTEC - First Trust NASDAQ-100- Technology Index Fund
QTNT - Quotient Limited
QTWW - Quantum Fuel Systems Technologies Worldwide, Inc.
QUIK - QuickLogic Corporation
QUMU - Qumu Corporation
QUNR - Qunar Cayman Islands Limited
QURE - uniQure N.V.
QVCA - Liberty Interactive Corporation
QVCB - Liberty Interactive Corporation
QYLD - Recon Capital NASDAQ-100 Covered Call ETF
RADA - Rada Electronics Industries Limited
RAIL - Freightcar America, Inc.
RAND - Rand Capital Corporation
RARE - Ultragenyx Pharmaceutical Inc.
RAVE - Rave Restaurant Group, Inc.
RAVN - Raven Industries, Inc.
RBCAA - Republic Bancorp, Inc.
RBCN - Rubicon Technology, Inc.
RBIO - rEVO Biologics, Inc.
RBPAA - Royal Bancshares of Pennsylvania, Inc.
RCII - Rent-A-Center Inc.
RCKY - Rocky Brands, Inc.
RCMT - RCM Technologies, Inc.
RCON - Recon Technology, Ltd.
RDCM - Radcom Ltd.
RDEN - Elizabeth Arden, Inc.
RDHL - Redhill Biopharma Ltd.
RDI - Reading International Inc
RDIB - Reading International Inc
RDNT - RadNet, Inc.
RDUS - Radius Health, Inc.
RDVY - First Trust NASDAQ Rising Dividend Achievers ETF
RDWR - Radware Ltd.
RECN - Resources Connection, Inc.
REDF - Rediff.com India Limited
REFR - Research Frontiers Incorporated
REGI - Renewable Energy Group, Inc.
REGN - Regeneron Pharmaceuticals, Inc.
REIS - Reis, Inc
RELL - Richardson Electronics, Ltd.
RELV - Reliv&#39; International, Inc.
RELY - Real Industry, Inc.
REPH - Recro Pharma, Inc.
RESN - Resonant Inc.
REXI - Resource America, Inc.
REXX - Rex Energy Corporation
RFIL - RF Industries, Ltd.
RGCO - RGC Resources Inc.
RGEN - Repligen Corporation
RGLD - Royal Gold, Inc.
RGLS - Regulus Therapeutics Inc.
RGNX - REGENXBIO Inc.
RGSE - Real Goods Solar, Inc.
RIBT - RiceBran Technologies
RIBTW - RiceBran Technologies
RICK - RCI Hospitality Holdings, Inc.
RIGL - Rigel Pharmaceuticals, Inc.
RILY - B. Riley Financial, Inc.
RITT - RIT Technologies Ltd.
RITTW - RIT Technologies Ltd.
RIVR - River Valley Bancorp.
RJET - Republic Airways Holdings, Inc.
RKDA - Arcadia Biosciences, Inc.
RLJE - RLJ Entertainment, Inc.
RLOC - ReachLocal, Inc.
RLOG - Rand Logistics, Inc.
RLYP - Relypsa, Inc.
RMBS - Rambus, Inc.
RMCF - Rocky Mountain Chocolate Factory, Inc.
RMGN - RMG Networks Holding Corporation
RMI - RiverBanc Multifamily Investors, Inc.
RMR - The RMR Group Inc.
RMTI - Rockwell Medical, Inc.
RNET - RigNet, Inc.
RNST - Renasant Corporation
RNVA - Rennova Health, Inc.
RNVAW - Rennova Health, Inc.
RNWK - RealNetworks, Inc.
ROBO - Robo-Stox Global Robotics and Automation Index ETF
ROCK - Gibraltar Industries, Inc.
ROIA - Radio One, Inc.
ROIAK - Radio One, Inc.
ROIC - Retail Opportunity Investments Corp.
ROKA - Roka Bioscience, Inc.
ROLL - RBC Bearings Incorporated
ROSG - Rosetta Genomics Ltd.
ROST - Ross Stores, Inc.
ROVI - Rovi Corporation
RP - RealPage, Inc.
RPD - Rapid7, Inc.
RPRX - Repros Therapeutics Inc.
RPTP - Raptor Pharmaceutical Corp.
RPXC - RPX Corporation
RRD - R.R. Donnelley & Sons Company
RRGB - Red Robin Gourmet Burgers, Inc.
RRM - RR Media Ltd.
RSAS - RESAAS Services Inc.
RSTI - Rofin-Sinar Technologies, Inc.
RSYS - RadiSys Corporation
RTIX - RTI Surgical, Inc.
RTK - Rentech, Inc.
RTRX - Retrophin, Inc.
RTTR - Ritter Pharmaceuticals, Inc.
RUN - Sunrun Inc.
RUSHA - Rush Enterprises, Inc.
RUSHB - Rush Enterprises, Inc.
RUTH - Ruth&#39;s Hospitality Group, Inc.
RVLT - Revolution Lighting Technologies, Inc.
RVNC - Revance Therapeutics, Inc.
RVSB - Riverview Bancorp Inc
RWLK - ReWalk Robotics Ltd
RXDX - Ignyta, Inc.
RXII - RXI Pharmaceuticals Corporation
RYAAY - Ryanair Holdings plc
SAAS - inContact, Inc.
SABR - Sabre Corporation
SAEX - SAExploration Holdings, Inc.
SAFM - Sanderson Farms, Inc.
SAFT - Safety Insurance Group, Inc.
SAGE - Sage Therapeutics, Inc.
SAIA - Saia, Inc.
SAJA - Sajan, Inc.
SAL - Salisbury Bancorp, Inc.
SALE - RetailMeNot, Inc.
SALM - Salem Media Group, Inc.
SAMG - Silvercrest Asset Management Group Inc.
SANM - Sanmina Corporation
SANW - S&W Seed Company
SASR - Sandy Spring Bancorp, Inc.
SATS - EchoStar Corporation
SAUC - Diversified Restaurant Holdings, Inc.
SAVE - Spirit Airlines, Inc.
SBAC - SBA Communications Corporation
SBBP - Strongbridge Biopharma plc
SBBX - Sussex Bancorp
SBCF - Seacoast Banking Corporation of Florida
SBCP - Sunshine Bancorp, Inc.
SBFG - SB Financial Group, Inc.
SBFGP - SB Financial Group, Inc.
SBGI - Sinclair Broadcast Group, Inc.
SBLK - Star Bulk Carriers Corp.
SBLKL - Star Bulk Carriers Corp.
SBNY - Signature Bank
SBNYW - Signature Bank
SBOT - Stellar Biotechnologies, Inc.
SBRA - Sabra Healthcare REIT, Inc.
SBRAP - Sabra Healthcare REIT, Inc.
SBSA - Spanish Broadcasting System, Inc.
SBSI - Southside Bancshares, Inc.
SBUX - Starbucks Corporation
SCAI - Surgical Care Affiliates, Inc.
SCCI - Shimmick Construction Company, Inc.
SCHL - Scholastic Corporation
SCHN - Schnitzer Steel Industries, Inc.
SCLN - SciClone Pharmaceuticals, Inc.
SCMP - Sucampo Pharmaceuticals, Inc.
SCON - Superconductor Technologies Inc.
SCOR - comScore, Inc.
SCSC - ScanSource, Inc.
SCSS - Select Comfort Corporation
SCTY - SolarCity Corporation
SCVL - Shoe Carnival, Inc.
SCYX - SCYNEXIS, Inc.
SCZ - iShares MSCI EAFE Small-Cap ETF
SEAC - SeaChange International, Inc.
SEDG - SolarEdge Technologies, Inc.
SEED - Origin Agritech Limited
SEIC - SEI Investments Company
SELF - Global Self Storage, Inc.
SEMI - SunEdison Semiconductor Limited
SENEA - Seneca Foods Corp.
SENEB - Seneca Foods Corp.
SEV - Sevcon, Inc.
SFBC - Sound Financial Bancorp, Inc.
SFBS - ServisFirst Bancshares, Inc.
SFLY - Shutterfly, Inc.
SFM - Sprouts Farmers Market, Inc.
SFNC - Simmons First National Corporation
SFST - Southern First Bancshares, Inc.
SGBK - Stonegate Bank
SGC - Superior Uniform Group, Inc.
SGEN - Seattle Genetics, Inc.
SGI - Silicon Graphics International Corp
SGMA - SigmaTron International, Inc.
SGMO - Sangamo BioSciences, Inc.
SGMS - Scientific Games Corp
SGNL - Signal Genetics, Inc.
SGNT - Sagent Pharmaceuticals, Inc.
SGOC - SGOCO Group, Ltd
SGRP - SPAR Group, Inc.
SGRY - Surgery Partners, Inc.
SGYP - Synergy Pharmaceuticals, Inc.
SGYPU - Synergy Pharmaceuticals, Inc.
SGYPW - Synergy Pharmaceuticals, Inc.
SHBI - Shore Bancshares Inc
SHEN - Shenandoah Telecommunications Co
SHIP - Seanergy Maritime Holdings Corp
SHLD - Sears Holdings Corporation
SHLDW - Sears Holdings Corporation
SHLM - A. Schulman, Inc.
SHLO - Shiloh Industries, Inc.
SHOO - Steven Madden, Ltd.
SHOR - ShoreTel, Inc.
SHOS - Sears Hometown and Outlet Stores, Inc.
SHPG - Shire plc
SHSP - SharpSpring, Inc.
SIEB - Siebert Financial Corp.
SIEN - Sientra, Inc.
SIFI - SI Financial Group, Inc.
SIFY - Sify Technologies Limited
SIGI - Selective Insurance Group, Inc.
SIGM - Sigma Designs, Inc.
SILC - Silicom Ltd
SIMO - Silicon Motion Technology Corporation
SINA - Sina Corporation
SINO - Sino-Global Shipping America, Ltd.
SIRI - Sirius XM Holdings Inc.
SIRO - Sirona Dental Systems, Inc.
SITO - SITO Mobile, Ltd.
SIVB - SVB Financial Group
SIVBO - SVB Financial Group
SIXD - 6D Global Technologies, Inc.
SKIS - Peak Resorts, Inc.
SKLN - Skyline Medical Inc.
SKLNU - Skyline Medical Inc.
SKOR - FlexShares Credit-Scored US Corporate Bond Index Fund
SKUL - Skullcandy, Inc.
SKYS - Sky Solar Holdings, Ltd.
SKYW - SkyWest, Inc.
SKYY - First Trust ISE Cloud Computing Index Fund
SLAB - Silicon Laboratories, Inc.
SLCT - Select Bancorp, Inc.
SLGN - Silgan Holdings Inc.
SLM - SLM Corporation
SLMAP - SLM Corporation
SLMBP - SLM Corporation
SLP - Simulations Plus, Inc.
SLQD - iShares 0-5 Year Investment Grade Corporate Bond ETF
SLRC - Solar Capital Ltd.
SLTD - Solar3D, Inc.
SLVO - region
SMBC - Southern Missouri Bancorp, Inc.
SMBK - SmartFinancial, Inc.
SMCI - Super Micro Computer, Inc.
SMCP - AlphaMark Actively Managed Small Cap ETF
SMED - Sharps Compliance Corp
SMIT - Schmitt Industries, Inc.
SMLR - Semler Scientific, Inc.
SMMF - Summit Financial Group, Inc.
SMMT - Summit Therapeutics plc
SMRT - Stein Mart, Inc.
SMSI - Smith Micro Software, Inc.
SMT - SMART Technologies Inc.
SMTC - Semtech Corporation
SMTX - SMTC Corporation
SNAK - Inventure Foods, Inc.
SNBC - Sun Bancorp, Inc.
SNC - State National Companies, Inc.
SNCR - Synchronoss Technologies, Inc.
SNDE - Sundance Energy Australia Limited
SNDK - SanDisk Corporation
SNDX - Syndax Pharmaceuticals, Inc.
SNFCA - Security National Financial Corporation
SNHY - Sun Hydraulics Corporation
SNMX - Senomyx, Inc.
SNPS - Synopsys, Inc.
SNSS - Sunesis Pharmaceuticals, Inc.
SNTA - Synta Pharmaceuticals Corp.
SOCB - Southcoast Financial Corporation
SOCL - Global X Social Media Index ETF
SODA - SodaStream International Ltd.
SOFO - Sonic Foundry, Inc.
SOHO - Sotherly Hotels Inc.
SOHOL - Sotherly Hotels LP
SOHOM - Sotherly Hotels LP
SOHU - Sohu.com Inc.
SONA - Southern National Bancorp of Virginia, Inc.
SONC - Sonic Corp.
SONS - Sonus Networks, Inc.
SORL - SORL Auto Parts, Inc.
SOXX - iShares PHLX SOX Semiconductor Sector Index Fund
SP - SP Plus Corporation
SPAN - Span-America Medical Systems, Inc.
SPAR - Spartan Motors, Inc.
SPCB - SuperCom, Ltd.
SPEX - Spherix Incorporated
SPHS - Sophiris Bio, Inc.
SPI - SPI Energy Co., Ltd.
SPIL - Siliconware Precision Industries Company, Ltd.
SPKE - Spark Energy, Inc.
SPLK - Splunk Inc.
SPLS - Staples, Inc.
SPNC - The Spectranetics Corporation
SPNE - SeaSpine Holdings Corporation
SPNS - Sapiens International Corporation N.V.
SPOK - Spok Holdings, Inc.
SPPI - Spectrum Pharmaceuticals, Inc.
SPRT - support.com, Inc.
SPSC - SPS Commerce, Inc.
SPTN - SpartanNash Company
SPU - SkyPeople Fruit Juice, Inc.
SPWH - Sportsman&#39;s Warehouse Holdings, Inc.
SPWR - SunPower Corporation
SQBG - Sequential Brands Group, Inc.
SQI - SciQuest, Inc.
SQNM - Sequenom, Inc.
SQQQ - ProShares UltraPro Short QQQ
SRAQ - Silver Run Acquisition Corporation
SRCE - 1st Source Corporation
SRCL - Stericycle, Inc.
SRCLP - Stericycle, Inc.
SRDX - SurModics, Inc.
SRET - Global X SuperDividend REIT ETF
SREV - ServiceSource International, Inc.
SRNE - Sorrento Therapeutics, Inc.
SRPT - Sarepta Therapeutics, Inc.
SRSC - Sears Canada Inc.
SRVA - SIRVA, Inc.
SSB - South State Corporation
SSBI - Summit State Bank
SSFN - Stewardship Financial Corp
SSH - Sunshine Heart Inc
SSKN - Strata Skin Sciences, Inc.
SSNC - SS&C Technologies Holdings, Inc.
SSRG - Symmetry Surgical Inc.
SSRI - Silver Standard Resources Inc.
SSYS - Stratasys, Ltd.
STAA - STAAR Surgical Company
STAF - Staffing 360 Solutions, Inc.
STB - Student Transportation Inc
STBA - S&T Bancorp, Inc.
STBZ - State Bank Financial Corporation.
STCK - BMC Stock Holdings, Inc.
STDY - SteadyMed Ltd.
STEM - StemCells, Inc.
STFC - State Auto Financial Corporation
STKL - SunOpta, Inc.
STKS - The ONE Group Hospitality, Inc.
STLD - Steel Dynamics, Inc.
STLY - Stanley Furniture Company, Inc.
STML - Stemline Therapeutics, Inc.
STMP - Stamps.com Inc.
STPP - region
STRA - Strayer Education, Inc.
STRL - Sterling Construction Company Inc
STRM - Streamline Health Solutions, Inc.
STRS - Stratus Properties, Inc.
STRT - Strattec Security Corporation
STRZA - Starz
STRZB - Starz
STX - Seagate Technology PLC
STXS - Stereotaxis, Inc.
SUMR - Summer Infant, Inc.
SUNS - Solar Senior Capital Ltd.
SUPN - Supernus Pharmaceuticals, Inc.
SVA - Sinovac Biotech, Ltd.
SVBI - Severn Bancorp Inc
SVVC - Firsthand Technology Value Fund, Inc.
SWHC - Smith & Wesson Holding Corporation
SWIR - Sierra Wireless, Inc.
SWKS - Skyworks Solutions, Inc.
SXCL - Steel Excel Inc.
SYBT - Stock Yards Bancorp, Inc.
SYKE - Sykes Enterprises, Incorporated
SYMC - Symantec Corporation
SYMX - Synthesis Energy Systems, Inc.
SYNA - Synaptics Incorporated
SYNC - Synacor, Inc.
SYNL - Synalloy Corporation
SYNT - Syntel, Inc.
SYPR - Sypris Solutions, Inc.
SYRX - Sysorex Global
SYUT - Synutra International, Inc.
SZMK - Sizmek Inc.
SZYM - Solazyme, Inc.
TACO - Del Taco Restaurants, Inc.
TACOW - Del Taco Restaurants, Inc.
TACT - TransAct Technologies Incorporated
TAIT - Taitron Components Incorporated
TANH - Tantech Holdings Ltd.
TAPR - region
TASR - TASER International, Inc.
TAST - Carrols Restaurant Group, Inc.
TATT - TAT Technologies Ltd.
TAX - Liberty Tax, Inc.
TAXI - Medallion Financial Corp.
TAYD - Taylor Devices, Inc.
TBBK - The Bancorp, Inc.
TBIO - Transgenomic, Inc.
TBK - Triumph Bancorp, Inc.
TBNK - Territorial Bancorp Inc.
TBPH - Theravance Biopharma, Inc.
TBRA - Tobira Therapeutics, Inc.
TCBI - Texas Capital Bancshares, Inc.
TCBIL - Texas Capital Bancshares, Inc.
TCBIP - Texas Capital Bancshares, Inc.
TCBIW - Texas Capital Bancshares, Inc.
TCBK - TriCo Bancshares
TCCO - Technical Communications Corporation
TCFC - The Community Financial Corporation
TCON - TRACON Pharmaceuticals, Inc.
TCPC - TCP Capital Corp.
TCRD - THL Credit, Inc.
TCX - Tucows Inc.
TDIV - First Trust NASDAQ Technology Dividend Index Fund
TEAM - Atlassian Corporation Plc
TEAR - TearLab Corporation
TECD - Tech Data Corporation
TECH - Bio-Techne Corp
TEDU - Tarena International, Inc.
TENX - Tenax Therapeutics, Inc.
TERP - TerraForm Power, Inc.
TESO - Tesco Corporation
TESS - TESSCO Technologies Incorporated
TFM - The Fresh Market, Inc.
TFSC - 1347 Capital Corp.
TFSCR - 1347 Capital Corp.
TFSCU - 1347 Capital Corp.
TFSCW - 1347 Capital Corp.
TFSL - TFS Financial Corporation
TGA - Transglobe Energy Corp
TGEN - Tecogen Inc.
TGLS - Tecnoglass Inc.
TGTX - TG Therapeutics, Inc.
THFF - First Financial Corporation Indiana
THLD - Threshold Pharmaceuticals, Inc.
THRM - Gentherm Inc
THST - Truett-Hurst, Inc.
TICC - TICC Capital Corp.
TIL - Till Capital Ltd.
TILE - Interface, Inc.
TINY - Harris & Harris Group, Inc.
TIPT - Tiptree Financial Inc.
TISA - Top Image Systems, Ltd.
TITN - Titan Machinery Inc.
TIVO - TiVo Inc.
TKAI - Tokai Pharmaceuticals, Inc.
TLF - Tandy Leather Factory, Inc.
TLGT - Teligent, Inc.
TLMR - Talmer Bancorp, Inc.
TLOG - TetraLogic Pharmaceuticals Corporation
TLT - iShares 20+ Year Treasury Bond ETF
TMUS - T-Mobile US, Inc.
TMUSP - T-Mobile US, Inc.
TNAV - TeleNav, Inc.
TNDM - Tandem Diabetes Care, Inc.
TNGO - Tangoe, Inc.
TNXP - Tonix Pharmaceuticals Holding Corp.
TOPS - TOP Ships Inc.
TOR - Sutor Technology Group Limited
TORM - TOR Minerals International Inc
TOUR - Tuniu Corporation
TOWN - Towne Bank
TQQQ - ProShares UltraPro QQQ
TRCB - Two River Bancorp
TRCH - Torchlight Energy Resources, Inc.
TREE - LendingTree, Inc.
TRIB - Trinity Biotech plc
TRIL - Trillium Therapeutics Inc.
TRIP - TripAdvisor, Inc.
TRMB - Trimble Navigation Limited
TRMK - Trustmark Corporation
TRNS - Transcat, Inc.
TROV - TrovaGene, Inc.
TROVU - TrovaGene, Inc.
TROVW - TrovaGene, Inc.
TROW - T. Rowe Price Group, Inc.
TRS - TriMas Corporation
TRST - TrustCo Bank Corp NY
TRTL - Terrapin 3 Acquisition Corporation
TRTLU - Terrapin 3 Acquisition Corporation
TRTLW - Terrapin 3 Acquisition Corporation
TRVN - Trevena, Inc.
TSBK - Timberland Bancorp, Inc.
TSC - TriState Capital Holdings, Inc.
TSCO - Tractor Supply Company
TSEM - Tower Semiconductor Ltd.
TSLA - Tesla Motors, Inc.
TSRA - Tessera Technologies, Inc.
TSRI - TSR, Inc.
TSRO - TESARO, Inc.
TST - TheStreet, Inc.
TSYS - TeleCommunication Systems, Inc.
TTEC - TeleTech Holdings, Inc.
TTEK - Tetra Tech, Inc.
TTGT - TechTarget, Inc.
TTHI - Transition Therapeutics, Inc.
TTMI - TTM Technologies, Inc.
TTNP - Titan Pharmaceuticals, Inc.
TTOO - T2 Biosystems, Inc.
TTPH - Tetraphase Pharmaceuticals, Inc.
TTS - Tile Shop Hldgs, Inc.
TTWO - Take-Two Interactive Software, Inc.
TUBE - TubeMogul, Inc.
TUES - Tuesday Morning Corp.
TUSA - First Trust Total US Market AlphaDEX ETF
TUTI - Tuttle Tactical Management Multi-Strategy Income ETF
TUTT - Tuttle Tactical Management U.S. Core ETF
TVIX - region
TVIZ - region
TWER - Towerstream Corporation
TWIN - Twin Disc, Incorporated
TWMC - Trans World Entertainment Corp.
TWOU - 2U, Inc.
TXN - Texas Instruments Incorporated
TXRH - Texas Roadhouse, Inc.
TYPE - Monotype Imaging Holdings Inc.
TZOO - Travelzoo Inc.
UACL - Universal Truckload Services, Inc.
UAE - iShares MSCI UAE Capped ETF
UBCP - United Bancorp, Inc.
UBFO - United Security Bancshares
UBIC - UBIC, Inc.
UBIO - Proshares UltraPro Nasdaq Biotechnology
UBND - WisdomTree Western Asset Unconstrained Bond Fund
UBNK - United Financial Bancorp, Inc.
UBNT - Ubiquiti Networks, Inc.
UBOH - United Bancshares, Inc.
UBSH - Union Bankshares Corporation
UBSI - United Bankshares, Inc.
UCBA - United Community Bancorp
UCBI - United Community Banks, Inc.
UCFC - United Community Financial Corp.
UCTT - Ultra Clean Holdings, Inc.
UDBI - Legg Mason US Diversified Core ETF
UDF - United Development Funding IV
UEIC - Universal Electronics Inc.
UEPS - Net 1 UEPS Technologies, Inc.
UFCS - United Fire Group, Inc
UFPI - Universal Forest Products, Inc.
UFPT - UFP Technologies, Inc.
UG - United-Guardian, Inc.
UGLD - region
UHAL - Amerco
UIHC - United Insurance Holdings Corp.
UK - Recon Capital FTSE 100 ETF
ULBI - Ultralife Corporation
ULTA - Ulta Salon, Cosmetics & Fragrance, Inc.
ULTI - The Ultimate Software Group, Inc.
ULTR - Ultrapetrol (Bahamas) Limited
UMBF - UMB Financial Corporation
UMPQ - Umpqua Holdings Corporation
UNAM - Unico American Corporation
UNB - Union Bankshares, Inc.
UNFI - United Natural Foods, Inc.
UNIS - Unilife Corporation
UNTD - United Online, Inc.
UNTY - Unity Bancorp, Inc.
UNXL - Uni-Pixel, Inc.
UPIP - Unwired Planet, Inc.
UPLD - Upland Software, Inc.
URBN - Urban Outfitters, Inc.
UREE - U.S. Rare Earths, Inc.
URRE - Uranium Resources, Inc.
USAK - USA Truck, Inc.
USAP - Universal Stainless & Alloy Products, Inc.
USAT - USA Technologies, Inc.
USATP - USA Technologies, Inc.
USBI - United Security Bancshares, Inc.
USCR - U S Concrete, Inc.
USEG - U.S. Energy Corp.
USLB - PowerShares Russell 1000 Low Beta Equal Weight Portfolio
USLM - United States Lime & Minerals, Inc.
USLV - region
USMD - USMD Holdings, Inc.
UTEK - Ultratech, Inc.
UTES - Reaves Utilities ETF
UTHR - United Therapeutics Corporation
UTMD - Utah Medical Products, Inc.
UTSI - UTStarcom Holdings Corp
UVSP - Univest Corporation of Pennsylvania
VA - Virgin America Inc.
VALU - Value Line, Inc.
VALX - Validea Market Legends ETF
VASC - Vascular Solutions, Inc.
VBFC - Village Bank and Trust Financial Corp.
VBIV - VBI Vaccines Inc.
VBLT - Vascular Biogenics Ltd.
VBND - Vident Core U.S. Bond Strategy Fund
VBTX - Veritex Holdings, Inc.
VCEL - Vericel Corporation
VCIT - Vanguard Intermediate-Term Corporate Bond ETF
VCLT - Vanguard Long-Term Corporate Bond ETF
VCSH - Vanguard Short-Term Corporate Bond ETF
VCYT - Veracyte, Inc.
VDSI - VASCO Data Security International, Inc.
VDTH - Videocon d2h Limited
VECO - Veeco Instruments Inc.
VGIT - Vanguard Intermediate -Term Government Bond ETF
VGLT - Vanguard Long-Term Government Bond ETF
VGSH - Vanguard Short-Term Government ETF
VIA - Viacom Inc.
VIAB - Viacom Inc.
VIAV - Viavi Solutions Inc.
VICL - Vical Incorporated
VICR - Vicor Corporation
VIDI - Vident International Equity Fund
VIIX - region
VIIZ - region
VIP - VimpelCom Ltd.
VIRC - Virco Manufacturing Corporation
VIRT - Virtu Financial, Inc.
VISN - VisionChina Media, Inc.
VIVO - Meridian Bioscience Inc.
VKTX - Viking Therapeutics, Inc.
VLGEA - Village Super Market, Inc.
VLTC - Voltari Corporation
VMBS - Vanguard Mortgage-Backed Securities ETF
VNDA - Vanda Pharmaceuticals Inc.
VNET - 21Vianet Group, Inc.
VNOM - Viper Energy Partners LP
VNQI - Vanguard Global ex-U.S. Real Estate ETF
VNR - Vanguard Natural Resources LLC
VNRAP - Vanguard Natural Resources LLC
VNRBP - Vanguard Natural Resources LLC
VNRCP - Vanguard Natural Resources LLC
VOD - Vodafone Group Plc
VONE - Vanguard Russell 1000 ETF
VONG - Vanguard Russell 1000 Growth ETF
VONV - Vanguard Russell 1000 Value ETF
VOXX - VOXX International Corporation
VRA - Vera Bradley, Inc.
VRML - Vermillion, Inc.
VRNG - Vringo, Inc.
VRNS - Varonis Systems, Inc.
VRNT - Verint Systems Inc.
VRSK - Verisk Analytics, Inc.
VRSN - VeriSign, Inc.
VRTB - Vestin Realty Mortgage II, Inc.
VRTS - Virtus Investment Partners, Inc.
VRTU - Virtusa Corporation
VRTX - Vertex Pharmaceuticals Incorporated
VSAR - Versartis, Inc.
VSAT - ViaSat, Inc.
VSCP - VirtualScopics, Inc.
VSEC - VSE Corporation
VSTM - Verastem, Inc.
VTAE - Vitae Pharmaceuticals, Inc.
VTHR - Vanguard Russell 3000 ETF
VTIP - Vanguard Short-Term Inflation-Protected Securities Index Fund
VTL - Vital Therapies, Inc.
VTNR - Vertex Energy, Inc
VTVT - vTv Therapeutics Inc.
VTWG - Vanguard Russell 2000 Growth ETF
VTWO - Vanguard Russell 2000 ETF
VTWV - Vanguard Russell 2000 Value ETF
VUSE - Vident Core US Equity ETF
VUZI - Vuzix Corporation
VVUS - VIVUS, Inc.
VWOB - Vanguard Emerging Markets Government Bond ETF
VWR - VWR Corporation
VXDN - AccuShares Spot CBOE VIX Down Shares
VXUP - AccuShares Spot CBOE VIX Up Shares
VXUS - Vanguard Total International Stock ETF
VYGR - Voyager Therapeutics, Inc.
WABC - Westamerica Bancorporation
WAFD - Washington Federal, Inc.
WAFDW - Washington Federal, Inc.
WASH - Washington Trust Bancorp, Inc.
WATT - Energous Corporation
WAYN - Wayne Savings Bancshares Inc.
WB - Weibo Corporation
WBA - Walgreens Boots Alliance, Inc.
WBB - Westbury Bancorp, Inc.
WBKC - Wolverine Bancorp, Inc.
WBMD - WebMD Health Corp
WDC - Western Digital Corporation
WDFC - WD-40 Company
WEB - Web.com Group, Inc.
WEBK - Wellesley Bancorp, Inc.
WEN - Wendy&#39;s Company (The)
WERN - Werner Enterprises, Inc.
WETF - WisdomTree Investments, Inc.
WEYS - Weyco Group, Inc.
WFBI - WashingtonFirst Bankshares Inc
WFD - Westfield Financial, Inc.
WFM - Whole Foods Market, Inc.
WGBS - WaferGen Bio-systems, Inc.
WHF - WhiteHorse Finance, Inc.
WHFBL - WhiteHorse Finance, Inc.
WHLM - Wilhelmina International, Inc.
WHLR - Wheeler Real Estate Investment Trust, Inc.
WHLRP - Wheeler Real Estate Investment Trust, Inc.
WHLRW - Wheeler Real Estate Investment Trust, Inc.
WIBC - Wilshire Bancorp, Inc.
WIFI - Boingo Wireless, Inc.
WILC - G. Willi-Food International,  Ltd.
WILN - Wi-Lan Inc
WIN - Windstream Holdings, Inc.
WINA - Winmark Corporation
WING - Wingstop Inc.
WINS - Wins Finance Holdings Inc.
WIRE - Encore Wire Corporation
WIX - Wix.com Ltd.
WKHS - Workhorse Group, Inc.
WLB - Westmoreland Coal Company
WLDN - Willdan Group, Inc.
WLFC - Willis Lease Finance Corporation
WLRH - WL Ross Holding Corp.
WLRHU - WL Ross Holding Corp.
WLRHW - WL Ross Holding Corp.
WLTW - Willis Towers Watson Public Limited Company
WMAR - West Marine, Inc.
WMGI - Wright Medical Group N.V.
WMGIZ - Wright Medical Group N.V.
WMIH - WMIH Corp.
WNFM - Wayne Farms, Inc.
WOOD - iShares S&P Global Timber & Forestry Index Fund
WOOF - VCA Inc.
WOWO - Wowo Limited
WPCS - WPCS International Incorporated
WPPGY - WPP plc
WPRT - Westport Innovations Inc
WRES - Warren Resources, Inc.
WRLD - World Acceptance Corporation
WSBC - WesBanco, Inc.
WSBF - Waterstone Financial, Inc.
WSCI - WSI Industries Inc.
WSFS - WSFS Financial Corporation
WSFSL - WSFS Financial Corporation
WSTC - West Corporation
WSTG - Wayside Technology Group, Inc.
WSTL - Westell Technologies, Inc.
WTBA - West Bancorporation
WTFC - Wintrust Financial Corporation
WTFCM - Wintrust Financial Corporation
WTFCW - Wintrust Financial Corporation
WVE - WAVE Life Sciences Ltd.
WVFC - WVS Financial Corp.
WVVI - Willamette Valley Vineyards, Inc.
WVVIP - Willamette Valley Vineyards, Inc.
WWD - Woodward, Inc.
WYIG - JM Global Holding Company
WYIGU - JM Global Holding Company
WYIGW - JM Global Holding Company
WYNN - Wynn Resorts, Limited
XBIT - XBiotech Inc.
XBKS - Xenith Bankshares, Inc.
XCOM - Xtera Communications, Inc.
XCRA - Xcerra Corporation
XELB - Xcel Brands, Inc
XENE - Xenon Pharmaceuticals Inc.
XENT - Intersect ENT, Inc.
XGTI - XG Technology, Inc
XGTIW - XG Technology, Inc
XIV - region
XLNX - Xilinx, Inc.
XLRN - Acceleron Pharma Inc.
XNCR - Xencor, Inc.
XNET - Xunlei Limited
XNPT - XenoPort, Inc.
XOMA - XOMA Corporation
XONE - The ExOne Company
XPLR - Xplore Technologies Corp
XRAY - DENTSPLY International Inc.
XRDC - Crossroads Capital, Inc.
XTLB - XTL Biopharmaceuticals Ltd.
XXIA - Ixia
YCB - Your Community Bankshares, Inc.
YDIV - First Trust International Multi-Asset Diversified Income Index
YECO - Yulong Eco-Materials Limited
YHOO - Yahoo! Inc.
YLCO - Global X Yieldco Index ETF
YNDX - Yandex N.V.
YOD - You On Demand Holdings, Inc.
YORW - The York Water Company
YPRO - AdvisorShares YieldPro ETF
YRCW - YRC Worldwide, Inc.
YY - YY Inc.
Z - Zillow Group, Inc.
ZAGG - ZAGG Inc
ZAIS - ZAIS Group Holdings, Inc.
ZBIO - ProShares UltraPro Short NASDAQ Biotechnology
ZBRA - Zebra Technologies Corporation
ZEUS - Olympic Steel, Inc.
ZFGN - Zafgen, Inc.
ZG - Zillow Group, Inc.
ZGNX - Zogenix, Inc.
ZHNE - Zhone Technologies, Inc.
ZION - Zions Bancorporation
ZIONW - Zions Bancorporation
ZIONZ - Zions Bancorporation
ZIOP - ZIOPHARM Oncology Inc
ZIV - region
ZIXI - Zix Corporation
ZLIG - Aperion Biologics, Inc.
ZLTQ - ZELTIQ Aesthetics, Inc.
ZN - Zion Oil & Gas Inc
ZNGA - Zynga Inc.
ZNWAA - Zion Oil & Gas Inc
ZSAN - Zosano Pharma Corporation
ZUMZ - Zumiez Inc.
ZYNE - Zynerba Pharmaceuticals, Inc.
TRUE - TrueCar, Inc.